File Name,File Definition,Number of 16S Extracted,Reason for No Extraction,Number of Keep Sequences,Number of Outlier Sequences,Number of different sequences saved
GCF_000240325.1_ASM24032v1_genomic.gbff.gz,"Klebsiella michiganensis KCTC 1686, complete sequence",8,,3,5,1
GCF_000247835.1_Kleb_oxyt_10-5242_V1_genomic.gbff.gz,"Klebsiella michiganensis strain Oct-42 supercont1.1, whole genome shotgun sequence",7,,7,0,2
GCF_000247855.1_Kleb_oxyt_10-5243_V1_genomic.gbff.gz,"Klebsiella oxytoca 10-5243 strain Oct-43 supercont1.1, whole genome shotgun sequence",7,,6,1,2
GCF_000247875.1_Kleb_oxyt_10-5245_V1_genomic.gbff.gz,"Klebsiella oxytoca 10-5245 strain Oct-45 supercont1.1, whole genome shotgun sequence",1,,1,0,1
GCF_000252915.1_Ko11492-1_1.0_genomic.gbff.gz,"Klebsiella oxytoca 11492-1 contig_213, whole genome shotgun sequence",0,All rRNA sequences shorter than 1400 bases,0,0
GCF_000252915.2_Ko11492-1_1.0_genomic.gbff.gz,"Klebsiella oxytoca 11492-1 contig_213, whole genome shotgun sequence",0,All rRNA sequences shorter than 1400 bases,0,0
GCF_000269585.1_PB_Kleb_oxyt_10-5248_V1_genomic.gbff.gz,"Klebsiella oxytoca 10-5248 cont1.1, whole genome shotgun sequence",8,,3,5,1
GCF_000276705.2_ASM27670v2_genomic.gbff.gz,"Klebsiella michiganensis E718, complete sequence",8,,6,2,1
GCF_000492815.1_Kleb_oxyt_MGH_42_V1_genomic.gbff.gz,"Klebsiella oxytoca MGH 42 addTf-supercont1.1, whole genome shotgun sequence",8,,2,6,2
GCF_000492955.1_Kleb_oxyt_MGH_28_V1_genomic.gbff.gz,"Klebsiella oxytoca MGH 28 addUR-supercont1.1, whole genome shotgun sequence",8,,5,3,2
GCF_000507385.1_ASM50738v1_genomic.gbff.gz,"Klebsiella oxytoca BRL6-2 G360DRAFT_scaffold00001.1_C, whole genome shotgun sequence",8,,5,3,1
GCF_000527215.1_KoxKA2v1.0_genomic.gbff.gz,"Klebsiella oxytoca KA-2 ctgN140L547191C22.1634, whole genome shotgun sequence",3,,3,0,1
GCF_000527235.1_KoxOK1v1.0_genomic.gbff.gz,"Klebsiella oxytoca OK-1 ctgN23L1391C31.5262, whole genome shotgun sequence",1,,1,0,1
GCF_000567705.1_Kleb_oxyt_MGH_41_V1_genomic.gbff.gz,"Klebsiella michiganensis strain MGH 41 adjbu-supercont1.1, whole genome shotgun sequence",6,,2,4,2
GCF_000567805.1_Kleb_oxyt_MGH_27_V1_genomic.gbff.gz,"Klebsiella michiganensis strain MGH 27 adjbQ-supercont1.1, whole genome shotgun sequence",5,,2,3,2
GCF_000607265.1_Kleb_oxyt_G54_V1_genomic.gbff.gz,"Klebsiella oxytoca G54 adHqJ-supercont1.1, whole genome shotgun sequence",5,,3,2,2
GCF_000632415.1_ASM63241v1_genomic.gbff.gz,"Klebsiella michiganensis HKOPL1 chromosome, complete genome",8,,8,0,1
GCF_000633235.1_ASM63323v1_genomic.gbff.gz,"Klebsiella michiganensis H1g Contig1, whole genome shotgun sequence",1,,1,0,1
GCF_000724525.1_ASM72452v1_genomic.gbff.gz,"Klebsiella michiganensis strain M1 chromosome, complete genome",8,,4,4,2
GCF_000735215.1_ASM73521v1_genomic.gbff.gz,"Klebsiella michiganensis strain R8A contig_1, whole genome shotgun sequence",1,,1,0,1
GCF_000783895.1_ASM78389v1_genomic.gbff.gz,"Klebsiella michiganensis strain FDAARGOS_66 1quiver, whole genome shotgun sequence",9,,4,5,2
GCF_000783895.2_ASM78389v2_genomic.gbff.gz,"Klebsiella michiganensis strain FDAARGOS_66 1_quiver_pilon, whole genome shotgun sequence",9,,4,5,2
GCF_001006545.1_ASM100654v1_genomic.gbff.gz,"Klebsiella michiganensis strain CH2 contig1, whole genome shotgun sequence",1,,1,0,1
GCF_001022115.1_ASM102211v1_genomic.gbff.gz,"Klebsiella oxytoca strain CAV1335 chromosome, complete genome",8,,4,4,1
GCF_001022295.1_ASM102229v1_genomic.gbff.gz,"Klebsiella oxytoca strain CAV1099 chromosome, complete genome",8,,3,5,1
GCF_001028875.1_ASM102887v1_genomic.gbff.gz,"Klebsiella michiganensis strain PHS-892 NODE_1, whole genome shotgun sequence",0,All rRNA sequences shorter than 1400 bases,0,0
GCF_001028885.1_ASM102888v1_genomic.gbff.gz,"Klebsiella michiganensis strain PHS-890 NODE_1, whole genome shotgun sequence",0,All rRNA sequences shorter than 1400 bases,0,0
GCF_001030705.1_Kleb_oxyt_CHS143_V1_genomic.gbff.gz,"Klebsiella oxytoca strain CHS143 aetza-supercont1.1, whole genome shotgun sequence",4,No sequences for consensus alignment,0,4,0
GCF_001030755.1_Kleb_oxyt_MGH87_V1_genomic.gbff.gz,"Klebsiella michiganensis strain MGH87 aetAw-supercont1.1, whole genome shotgun sequence",8,,2,6,2
GCF_001030775.1_Kleb_oxyt_MGH88_V1_genomic.gbff.gz,"Klebsiella oxytoca strain MGH88 aetyR-supercont1.1, whole genome shotgun sequence",8,,6,2,2
GCF_001038305.1_ASM103830v1_genomic.gbff.gz,"Klebsiella michiganensis strain GY84G39 contig_1, whole genome shotgun sequence",1,,1,0,1
GCF_001051455.1_ASM105145v1_genomic.gbff.gz,"Klebsiella michiganensis strain CH5 contig1, whole genome shotgun sequence",1,,1,0,1
GCF_001052035.1_ASM105203v1_genomic.gbff.gz,"Klebsiella michiganensis strain 1081_KOXY 100_47877_836678, whole genome shotgun sequence",1,,1,0,1
GCF_001052045.1_ASM105204v1_genomic.gbff.gz,"Klebsiella michiganensis strain 1082_KOXY 101_15082_205491, whole genome shotgun sequence",1,,1,0,1
GCF_001052525.1_ASM105252v1_genomic.gbff.gz,"Klebsiella michiganensis strain 1246_KOXY 1000_10109_133491_345+,192+,605+, whole genome shotgun sequence",1,,1,0,1
GCF_001052785.1_ASM105278v1_genomic.gbff.gz,"Klebsiella michiganensis strain 1084_KOXY 0_95972_1215158, whole genome shotgun sequence",1,,1,0,1
GCF_001053715.1_ASM105371v1_genomic.gbff.gz,"Klebsiella oxytoca strain 1047_KOXY 101_93913_1275386, whole genome shotgun sequence",1,,1,0,1
GCF_001053845.1_ASM105384v1_genomic.gbff.gz,"Klebsiella michiganensis strain 1085_KOXY 0_589_7974, whole genome shotgun sequence",2,,2,0,2
GCF_001053875.1_ASM105387v1_genomic.gbff.gz,"Klebsiella michiganensis strain 1113_KOXY 1000_6509_69903, whole genome shotgun sequence",1,,1,0,1
GCF_001054575.1_ASM105457v1_genomic.gbff.gz,"Klebsiella oxytoca strain 197_KOXY 1000_8305_148762_888_,380+,873+, whole genome shotgun sequence",1,,1,0,1
GCF_001054755.1_ASM105475v1_genomic.gbff.gz,"Klebsiella michiganensis strain 247_KOXY 1007_11494_138659, whole genome shotgun sequence",1,,1,0,1
GCF_001054935.1_ASM105493v1_genomic.gbff.gz,"Klebsiella oxytoca strain 346_KOXY 0_207_1463, whole genome shotgun sequence",1,,1,0,1
GCF_001055635.1_ASM105563v1_genomic.gbff.gz,"Klebsiella oxytoca strain 181_KOXY 1024_7100_94362, whole genome shotgun sequence",1,,1,0,1
GCF_001056405.1_ASM105640v1_genomic.gbff.gz,"Klebsiella michiganensis strain 337_KOXY 1000_14718_161481, whole genome shotgun sequence",3,,3,0,1
GCF_001056445.1_ASM105644v1_genomic.gbff.gz,"Klebsiella michiganensis strain 345_KOXY 1000_12331_127971, whole genome shotgun sequence",3,,3,0,1
GCF_001056765.1_ASM105676v1_genomic.gbff.gz,"Klebsiella michiganensis strain 442_KOXY 117_3541_966854, whole genome shotgun sequence",3,,3,0,1
GCF_001057405.1_ASM105740v1_genomic.gbff.gz,"Klebsiella oxytoca strain 582_KOXY 1014_13008_158076, whole genome shotgun sequence",4,,4,0,1
GCF_001063775.1_ASM106377v1_genomic.gbff.gz,"Klebsiella oxytoca strain 588_KOXY 1004_2618_23511, whole genome shotgun sequence",1,,1,0,1
GCF_001065715.1_ASM106571v1_genomic.gbff.gz,"Klebsiella oxytoca strain 633_KOXY 1000_49931_560047, whole genome shotgun sequence",1,,1,0,1
GCF_001066805.1_ASM106680v1_genomic.gbff.gz,"Klebsiella michiganensis strain 659_KOXY 1000_10507_120956, whole genome shotgun sequence",0,All rRNA sequences shorter than 1400 bases,0,0
GCF_001077175.1_ASM107717v1_genomic.gbff.gz,"Klebsiella michiganensis strain 793_KOXY 100_29454_515836, whole genome shotgun sequence",1,,1,0,1
GCF_001078175.1_Kleb_oxyt_09-7231_V1_genomic.gbff.gz,"Klebsiella oxytoca 09-7231 supercont1.1, whole genome shotgun sequence",4,No sequences for consensus alignment,0,4,0
GCF_001078195.1_Kleb_oxyt_10-5244_V1_genomic.gbff.gz,"Klebsiella oxytoca 10-5244 supercont1.1, whole genome shotgun sequence",4,No sequences for consensus alignment,0,4,0
GCF_001078235.1_Kleb_oxyt_10-5248_V1_genomic.gbff.gz,"Klebsiella oxytoca 10-5248 supercont1.1, whole genome shotgun sequence",5,,4,1,1
GCF_001078255.1_Kleb_oxyt_10-5249_V1_genomic.gbff.gz,"Klebsiella oxytoca 10-5249 supercont1.1, whole genome shotgun sequence",3,,2,1,2
GCF_001317245.1_ASM131724v1_genomic.gbff.gz,"Klebsiella michiganensis strain ST170:939742031 MIRA_c1, whole genome shotgun sequence",2,No sequences for consensus alignment,0,2,0
GCF_001583485.1_KlebPneuJA29_genomic.gbff.gz,"Klebsiella michiganensis strain UCD-JA29 contig-90_0, whole genome shotgun sequence",0,All rRNA sequences shorter than 1400 bases,0,0
GCF_001594375.1_ASM159437v1_genomic.gbff.gz,"Klebsiella oxytoca strain ICU1-2b contig_10, whole genome shotgun sequence",7,,3,4,1
GCF_001598695.1_ASM159869v1_genomic.gbff.gz,"Klebsiella oxytoca NBRC 105695, whole genome shotgun sequence",0,All rRNA sequences shorter than 1400 bases,0,0
GCF_001870185.1_ASM187018v1_genomic.gbff.gz,"Klebsiella oxytoca strain CAV1015 chromosome, complete genome",8,,3,5,1
GCF_001938605.1_ASM193860v1_genomic.gbff.gz,"Klebsiella michiganensis strain CAV1755 unitig_0, whole genome shotgun sequence",8,,5,3,2
GCF_001945455.1_ASM194545v1_genomic.gbff.gz,"Klebsiella michiganensis strain 97_38 Contig_1, whole genome shotgun sequence",1,,1,0,1
GCF_002119875.1_ASM211987v1_genomic.gbff.gz,"Klebsiella michiganensis strain 3T412C Contig_1, whole genome shotgun sequence",1,,1,0,1
GCF_002152315.1_ASM215231v1_genomic.gbff.gz,"Klebsiella michiganensis strain MGH175 scaffold00001, whole genome shotgun sequence",4,No sequences for consensus alignment,0,4,0
GCF_002152325.1_ASM215232v1_genomic.gbff.gz,"Klebsiella michiganensis strain MGH176 scaffold00001, whole genome shotgun sequence",2,No sequences for consensus alignment,0,2,0
GCF_002192755.1_ASM219275v1_genomic.gbff.gz,"Klebsiella michiganensis strain DPB_3 Cont1, whole genome shotgun sequence",0,All rRNA sequences shorter than 1400 bases,0,0
GCF_002216835.1_ASM221683v1_genomic.gbff.gz,"Klebsiella michiganensis strain K516 chromosome, complete genome",8,,5,3,1
GCF_002265195.1_ASM226519v1_genomic.gbff.gz,"Klebsiella michiganensis strain K1439 NODE_100_length_379_cov_0.952381, whole genome shotgun sequence",1,,1,0,1
GCF_002290285.1_ASM229028v1_genomic.gbff.gz,"Klebsiella michiganensis strain K518 chromosome, complete genome",8,,5,3,1
GCF_002508265.1_ASM250826v1_genomic.gbff.gz,"Klebsiella oxytoca strain UNM NODE_101_length_437_cov_1.11935_ID_201, whole genome shotgun sequence",1,,1,0,1
GCF_002588345.1_ASM258834v1_genomic.gbff.gz,"Klebsiella oxytoca strain FDAARGOS_432 pBCCDC_6.contig.0, whole genome shotgun sequence",8,,5,3,4
GCF_002852935.1_ASM285293v1_genomic.gbff.gz,"Klebsiella michiganensis strain SCKM020008 NODE_100_length_801_cov_116.403, whole genome shotgun sequence",1,,1,0,1
GCF_002853055.1_ASM285305v1_genomic.gbff.gz,"Klebsiella michiganensis strain SCKM020040 NODE_105_length_1249_cov_206.799, whole genome shotgun sequence",1,,1,0,1
GCF_002853195.1_ASM285319v1_genomic.gbff.gz,"Klebsiella oxytoca strain WCHKO085010 NODE_100_length_2733_cov_436.294, whole genome shotgun sequence",1,,1,0,1
GCF_002853215.1_ASM285321v1_genomic.gbff.gz,"Klebsiella oxytoca strain WCHKO085006 NODE_100_length_2498_cov_88.893, whole genome shotgun sequence",1,,1,0,1
GCF_002856965.1_ASM285696v1_genomic.gbff.gz,"Klebsiella michiganensis strain D40 NODE_100_length_19866_cov_4.37526, whole genome shotgun sequence",1,,1,0,1
GCF_002887165.1_ASM288716v1_genomic.gbff.gz,"Klebsiella michiganensis strain YD358 YD358_1, whole genome shotgun sequence",1,,1,0,1
GCF_002887605.1_ASM288760v1_genomic.gbff.gz,"Klebsiella michiganensis strain YDC736-2 YDC736_2_1, whole genome shotgun sequence",1,,1,0,1
GCF_002918665.1_ASM291866v1_genomic.gbff.gz,"Klebsiella michiganensis strain KONIH10 NODE_1, whole genome shotgun sequence",1,,1,0,1
GCF_002925905.1_ASM292590v1_genomic.gbff.gz,"Klebsiella michiganensis strain DSM 25444 map unlocalized plasmid unnamed1 contig_30, whole genome shotgun sequence",8,,6,2,3
GCF_002984395.1_ASM298439v1_genomic.gbff.gz,"Klebsiella oxytoca strain FDAARGOS_335 chromosome, complete genome",8,,6,2,2
GCF_003011775.1_ASM301177v1_genomic.gbff.gz,"Klebsiella michiganensis strain 2654 NODE_100_length_274_cov_131.734694, whole genome shotgun sequence",0,All rRNA sequences shorter than 1400 bases,0,0
GCF_003073975.1_ASM307397v1_genomic.gbff.gz,"Klebsiella oxytoca strain AR380 chromosome, complete genome",8,,8,0,3
GCF_003074075.1_ASM307407v1_genomic.gbff.gz,"Klebsiella michiganensis strain AR375 chromosome, complete genome",8,,6,2,3
GCF_003261555.1_ASM326155v1_genomic.gbff.gz,"Klebsiella grimontii strain WCHKG020121 1, whole genome shotgun sequence",1,,1,0,1
GCF_003261575.1_ASM326157v1_genomic.gbff.gz,"Klebsiella huaxiensis. WCHKl090001, whole genome shotgun sequence",0,All rRNA sequences shorter than 1400 bases,0,0
GCF_003261575.2_ASM326157v2_genomic.gbff.gz,"Klebsiella huaxiensis strain WCHKl090001 chromosome, complete genome",8,,7,1,2
GCF_003402095.1_ASM340209v1_genomic.gbff.gz,"Klebsiella michiganensis strain IS1015-72 NODE_100_length_939_cov_0.901478_ID_9142, whole genome shotgun sequence",1,,1,0,1
GCF_003590255.1_ASM359025v1_genomic.gbff.gz,"Klebsiella michiganensis strain XP-B1 contig000001, whole genome shotgun sequence",1,,1,0,1
GCF_003598595.1_ASM359859v1_genomic.gbff.gz,"Klebsiella michiganensis strain KMISG1 plasmid pKMISG1, whole genome shotgun sequence",1,,1,0,1
GCF_003693455.1_ASM369345v1_genomic.gbff.gz,"Klebsiella michiganensis strain 1016942 NODE_100_length_22626_cov_7.241310_pilon, whole genome shotgun sequence",1,,1,0,1
GCF_003812925.1_ASM381292v1_genomic.gbff.gz,"Klebsiella oxytoca strain FDAARGOS_500 chromosome, complete genome",8,,5,3,2
GCF_003937225.1_ASM393722v1_genomic.gbff.gz,"Klebsiella oxytoca strain KO_365 NODE_10_length_202885_cov_46.302818, whole genome shotgun sequence",0,All rRNA sequences shorter than 1400 bases,0,0
GCF_003991285.1_ASM399128v1_genomic.gbff.gz,"Klebsiella oxytoca strain ID154312 NODE_10_length_230067_cov_68.4786_ID_1768, whole genome shotgun sequence",1,,1,0,1
GCF_004005605.1_ASM400560v1_genomic.gbff.gz,"Klebsiella oxytoca strain 102B7 102B7_S95_R1_contig_1, whole genome shotgun sequence",1,,1,0,1
GCF_004024205.1_ASM402420v1_genomic.gbff.gz,"Klebsiella michiganensis strain GEO_33_Up_A NODE_100_length_17397_cov_12.7276, whole genome shotgun sequence",1,,1,0,1
GCF_004024445.1_ASM402444v1_genomic.gbff.gz,"Klebsiella michiganensis strain GEO_49_Down_A NODE_100_length_6209_cov_23.6146, whole genome shotgun sequence",1,,1,0,1
GCF_004102625.1_ASM410262v1_genomic.gbff.gz,"Klebsiella michiganensis strain M82255 chromosome, complete genome",8,,2,6,2
GCF_004104525.1_ASM410452v1_genomic.gbff.gz,"Klebsiella grimontii strain SS141 EHW69_1, whole genome shotgun sequence",0,All rRNA sequences shorter than 1400 bases,0,0
GCF_004104525.2_ASM410452v2_genomic.gbff.gz,"Klebsiella grimontii strain SS141 chromosome, complete genome",8,,6,2,1
GCF_004115315.1_ASM411531v1_genomic.gbff.gz,"Klebsiella michiganensis strain A202R3B6 NODE_100_length_2483_cov_38.0725_ID_199, whole genome shotgun sequence",1,,1,0,1
GCF_004156315.1_ASM415631v1_genomic.gbff.gz,"Klebsiella michiganensis strain Kox37 NODE_10_length_157455_cov_33.742366, whole genome shotgun sequence",1,,1,0,1
GCF_004343645.1_ASM434364v1_genomic.gbff.gz,"Klebsiella grimontii strain 2017H2G1 NODE_10_length_126342_cov_33.057077, whole genome shotgun sequence",0,All rRNA sequences shorter than 1400 bases,0,0
GCF_004360035.1_ASM436003v1_genomic.gbff.gz,"Klebsiella oxytoca strain SO-KOX16-1 NLHKJPMI_1, whole genome shotgun sequence",0,All rRNA sequences shorter than 1400 bases,0,0
GCF_004785705.1_ASM478570v1_genomic.gbff.gz,"Klebsiella oxytoca strain BX1S15 NODE_100_length_272_cov_0.733333, whole genome shotgun sequence",1,,1,0,1
GCF_007097115.1_ASM709711v1_genomic.gbff.gz,"Klebsiella michiganensis strain SDF3 NODE_10_length_220414_cov_32.780863, whole genome shotgun sequence",0,All rRNA sequences shorter than 1400 bases,0,0
GCF_007097185.1_ASM709718v1_genomic.gbff.gz,"Klebsiella michiganensis strain SDG3 NODE_10_length_198551_cov_32.123856, whole genome shotgun sequence",0,All rRNA sequences shorter than 1400 bases,0,0
GCF_007106885.1_ASM710688v1_genomic.gbff.gz,"Klebsiella michiganensis strain KNU07 chromosome, complete genome",8,,7,1,2
GCF_008082015.1_ASM808201v1_genomic.gbff.gz,"Klebsiella oxytoca strain T0143A.B-10 NODE_100_length_678_cov_62.6955, whole genome shotgun sequence",1,,1,0,1
GCF_008082295.1_ASM808229v1_genomic.gbff.gz,"Klebsiella oxytoca strain T0101B.F-13 NODE_100_length_1299_cov_1.75123, whole genome shotgun sequence",1,,1,0,1
GCF_008120085.1_ASM812008v1_genomic.gbff.gz,"Klebsiella michiganensis strain P095L Y scaffold_000001, whole genome shotgun sequence",1,,1,0,1
GCF_008120305.1_ASM812030v1_genomic.gbff.gz,"Klebsiella michiganensis strain P049A W scaffold_000001, whole genome shotgun sequence",1,,1,0,1
GCF_008120425.1_ASM812042v1_genomic.gbff.gz,"Klebsiella grimontii strain P043G P scaffold_000001, whole genome shotgun sequence",1,,1,0,1
GCF_008120465.1_ASM812046v1_genomic.gbff.gz,"Klebsiella grimontii strain P038I scaffold_000001, whole genome shotgun sequence",1,,1,0,1
GCF_008120915.1_ASM812091v1_genomic.gbff.gz,"Klebsiella grimontii strain P079F P scaffold_000001, whole genome shotgun sequence",1,,1,0,1
GCF_008121175.1_ASM812117v1_genomic.gbff.gz,"Klebsiella michiganensis strain T0101B.F-25 NODE_10_length_174291_cov_57.0309, whole genome shotgun sequence",1,,1,0,1
GCF_008364425.1_ASM836442v1_genomic.gbff.gz,"Klebsiella grimontii strain K1 NODE_10_length_258733_cov_29.3751, whole genome shotgun sequence",1,,1,0,1
GCF_008364425.2_ASM836442v2_genomic.gbff.gz,"Klebsiella grimontii strain K1 chromosome, complete genome",8,,5,3,2
GCF_008693565.1_ASM869356v1_genomic.gbff.gz,"Klebsiella michiganensis strain FDAARGOS_647 chromosome, complete genome",8,,5,3,2
GCF_008931605.1_ASM893160v1_genomic.gbff.gz,"Klebsiella michiganensis strain C52 chromosome, complete genome",8,,6,2,2
GCF_009173485.1_ASM917348v1_genomic.gbff.gz,"Klebsiella michiganensis strain CCUG 66515 contig_0000001, whole genome shotgun sequence",1,,1,0,1
GCF_009648435.1_ASM964843v1_genomic.gbff.gz,"Klebsiella oxytoca strain CLF20 CLF20_BDMS190049473-1a_1.clean_(paired)_contig_1, whole genome shotgun sequence",1,,1,0,1
GCF_009825595.1_ASM982559v1_genomic.gbff.gz,"Klebsiella michiganensis strain 1305118 NODE_10_length_237016_cov_25.2965, whole genome shotgun sequence",1,,1,0,1
GCF_009832375.1_ASM983237v1_genomic.gbff.gz,"Klebsiella oxytoca strain L3404 scaffold1, whole genome shotgun sequence",0,All rRNA sequences shorter than 1400 bases,0,0
GCF_009930855.1_ASM993085v1_genomic.gbff.gz,"Klebsiella michiganensis strain F107 chromosome, complete genome",8,,6,2,2
GCF_010093005.1_ASM1009300v1_genomic.gbff.gz,"Klebsiella michiganensis strain BD177 chromosome, complete genome",8,,5,3,2
GCF_010365605.1_ASM1036560v1_genomic.gbff.gz,"Klebsiella oxytoca strain 571.31 KLOX_S6_L001_1, whole genome shotgun sequence",0,All rRNA sequences shorter than 1400 bases,0,0
GCF_010588125.1_ASM1058812v1_genomic.gbff.gz,"Klebsiella michiganensis strain AS012494 AS012494_1, whole genome shotgun sequence",0,All rRNA sequences shorter than 1400 bases,0,0
GCF_010590025.1_ASM1059002v1_genomic.gbff.gz,"Klebsiella oxytoca strain AS012479 AS012479_1, whole genome shotgun sequence",1,,1,0,1
GCF_010590065.1_ASM1059006v1_genomic.gbff.gz,"Klebsiella michiganensis strain AS012477 AS012477_1, whole genome shotgun sequence",0,All rRNA sequences shorter than 1400 bases,0,0
GCF_010590245.1_ASM1059024v1_genomic.gbff.gz,"Klebsiella michiganensis strain AS012469 AS012469_1, whole genome shotgun sequence",0,All rRNA sequences shorter than 1400 bases,0,0
GCF_010590325.1_ASM1059032v1_genomic.gbff.gz,"Klebsiella oxytoca strain AS012465 AS012465_1, whole genome shotgun sequence",1,,1,0,1
GCF_010590505.1_ASM1059050v1_genomic.gbff.gz,"Klebsiella michiganensis strain AS012456 AS012456_1, whole genome shotgun sequence",0,All rRNA sequences shorter than 1400 bases,0,0
GCF_010590585.1_ASM1059058v1_genomic.gbff.gz,"Klebsiella oxytoca strain AS012448 AS012448_1, whole genome shotgun sequence",0,All rRNA sequences shorter than 1400 bases,0,0
GCF_010590665.1_ASM1059066v1_genomic.gbff.gz,"Klebsiella michiganensis strain AS012446 AS012446_1, whole genome shotgun sequence",1,,1,0,1
GCF_010592905.1_ASM1059290v1_genomic.gbff.gz,"Klebsiella michiganensis strain AS012383 AS012383_1, whole genome shotgun sequence",0,All rRNA sequences shorter than 1400 bases,0,0
GCF_010598605.1_ASM1059860v1_genomic.gbff.gz,"Klebsiella michiganensis strain AS012270 AS012270_1, whole genome shotgun sequence",0,All rRNA sequences shorter than 1400 bases,0,0
GCF_010598865.1_ASM1059886v1_genomic.gbff.gz,"Klebsiella oxytoca strain AS012254 AS012254_1, whole genome shotgun sequence",1,,1,0,1
GCF_010598965.1_ASM1059896v1_genomic.gbff.gz,"Klebsiella oxytoca strain AS012243 AS012243_1, whole genome shotgun sequence",0,All rRNA sequences shorter than 1400 bases,0,0
GCF_012395905.1_ASM1239590v1_genomic.gbff.gz,"Klebsiella oxytoca strain 18099069b contig00001, whole genome shotgun sequence",1,,1,0,1
GCF_013074375.1_ASM1307437v1_genomic.gbff.gz,"Klebsiella michiganensis strain JH07 Scaffold10_1, whole genome shotgun sequence",0,All rRNA sequences shorter than 1400 bases,0,0
GCF_013266825.1_ASM1326682v1_genomic.gbff.gz,"Klebsiella michiganensis strain CRN 27 S27_contig_1, whole genome shotgun sequence",1,,1,0,1
GCF_013392155.1_ASM1339215v1_genomic.gbff.gz,"Klebsiella michiganensis strain ZH142-C NODE_100_length_693_cov_1.298701, whole genome shotgun sequence",1,,1,0,1
GCF_013590775.1_ASM1359077v1_genomic.gbff.gz,"Klebsiella grimontii strain RHBSTW-00054 chromosome, complete genome",8,,7,1,1
GCF_013606065.1_ASM1360606v1_genomic.gbff.gz,"Klebsiella grimontii strain RHBSTW-00866 chromosome, complete genome",8,,8,0,1
GCF_013608545.1_ASM1360854v1_genomic.gbff.gz,"Klebsiella grimontii strain RHBSTW-00555 chromosome, complete genome",8,,7,1,1
GCF_013610655.1_ASM1361065v1_genomic.gbff.gz,"Klebsiella michiganensis strain RHBSTW-00409 chromosome, complete genome",8,,8,0,1
GCF_013624225.1_ASM1362422v1_genomic.gbff.gz,"Klebsiella grimontii strain RHBSTW-00181 chromosome, complete genome",8,,8,0,1
GCF_013624375.1_ASM1362437v1_genomic.gbff.gz,"Klebsiella michiganensis strain RHBSTW-00167 chromosome, complete genome",8,,8,0,1
GCF_013635015.1_ASM1363501v1_genomic.gbff.gz,"Klebsiella grimontii strain RHBSTW-00039 chromosome, complete genome",8,,7,1,1
GCF_013636415.1_ASM1363641v1_genomic.gbff.gz,"Klebsiella michiganensis strain RHB20-C02 chromosome, complete genome",8,,8,0,1
GCF_013707575.1_ASM1370757v1_genomic.gbff.gz,"Klebsiella grimontii strain RHBSTW-00165 chromosome, complete genome",8,,8,0,1
GCF_013730235.1_ASM1373023v1_genomic.gbff.gz,"Klebsiella grimontii strain RHBSTW-00853 chromosome, complete genome",8,,8,0,1
GCF_013732655.1_ASM1373265v1_genomic.gbff.gz,"Klebsiella michiganensis strain RHBSTW-00909 chromosome, complete genome",8,,8,0,1
GCF_013734595.1_ASM1373459v1_genomic.gbff.gz,"Klebsiella grimontii strain RHBSTW-00634 chromosome, complete genome",8,,7,1,1
GCF_013735435.1_ASM1373543v1_genomic.gbff.gz,"Klebsiella grimontii strain RHBSTW-00577 chromosome, complete genome",8,,6,2,2
GCF_013744615.1_ASM1374461v1_genomic.gbff.gz,"Klebsiella grimontii strain RHBSTW-00186 chromosome, complete genome",8,,8,0,1
GCF_013750595.1_ASM1375059v1_genomic.gbff.gz,"Klebsiella oxytoca strain RHBSTW-00373 chromosome, complete genome",8,,8,0,1
GCF_013821765.1_ASM1382176v1_genomic.gbff.gz,"Klebsiella michiganensis strain F52 N_100_length_501, whole genome shotgun sequence",0,All rRNA sequences shorter than 1400 bases,0,0
GCF_013826985.1_ASM1382698v1_genomic.gbff.gz,"Klebsiella oxytoca strain RHB30-C02 chromosome, complete genome",8,,8,0,1
GCF_013926025.1_ASM1392602v1_genomic.gbff.gz,Klebsiella michiganensis strain RHBSTW-00676 chromosome,8,,8,0,1
GCF_013926505.1_ASM1392650v1_genomic.gbff.gz,Klebsiella grimontii strain RHBSTW-00494 chromosome,8,,8,0,1
GCF_014050515.1_ASM1405051v1_genomic.gbff.gz,"Klebsiella michiganensis strain PS_Koxy4 NODE_100_length_1058_cov_28.712538, whole genome shotgun sequence",1,,1,0,1
GCF_014050515.2_ASM1405051v2_genomic.gbff.gz,"Klebsiella michiganensis strain PS_Koxy4 chromosome, complete genome",8,,6,2,1
GCF_014050535.1_ASM1405053v1_genomic.gbff.gz,"Klebsiella michiganensis strain PS_Koxy2 NODE_100_length_1089_cov_11.896245, whole genome shotgun sequence",1,,1,0,1
GCF_014050555.1_ASM1405055v1_genomic.gbff.gz,"Klebsiella michiganensis strain PS_Koxy1 NODE_100_length_1142_cov_2.887324, whole genome shotgun sequence",1,,1,0,1
GCF_014050555.2_ASM1405055v2_genomic.gbff.gz,"Klebsiella michiganensis strain PS_Koxy1 plasmid pPSKoxy1_1, whole genome shotgun sequence",8,,6,2,1
GCF_014103875.1_ASM1410387v1_genomic.gbff.gz,"Klebsiella grimontii strain RHBSTW-00189 plasmid pRHBSTW-00189_10, whole genome shotgun sequence",8,,8,0,1
GCF_014103895.1_ASM1410389v1_genomic.gbff.gz,"Klebsiella oxytoca strain RHBSTW-00178 plasmid pRHBSTW-00178_2, whole genome shotgun sequence",8,,7,1,1
GCF_014104195.1_ASM1410419v1_genomic.gbff.gz,"Klebsiella grimontii strain RHBSTW-00092 plasmid pRHBSTW-00092_2, whole genome shotgun sequence",8,,7,1,1
GCF_014105195.1_ASM1410519v1_genomic.gbff.gz,"Klebsiella michiganensis strain RHB20-C01 plasmid pRHB20-C01_2, whole genome shotgun sequence",8,,8,0,1
GCF_014129405.1_ASM1412940v1_genomic.gbff.gz,"Klebsiella michiganensis strain ZLTJD1 contig1, whole genome shotgun sequence",0,All rRNA sequences shorter than 1400 bases,0,0
GCF_014217275.1_ASM1421727v1_genomic.gbff.gz,"Klebsiella michiganensis strain AKKL-001 chromosome, complete genome",8,,8,0,1
GCF_014267425.1_ASM1426742v1_genomic.gbff.gz,"Klebsiella michiganensis strain Kop NODE_100_length_265_cov_0.787234, whole genome shotgun sequence",0,All rRNA sequences shorter than 1400 bases,0,0
GCF_014330695.1_ASM1433069v1_genomic.gbff.gz,"Klebsiella michiganensis strain EC608 contig00001, whole genome shotgun sequence",0,All rRNA sequences shorter than 1400 bases,0,0
GCF_014654995.1_ASM1465499v1_genomic.gbff.gz,"Klebsiella michiganensis strain SCKM090650 contig00001, whole genome shotgun sequence",0,All rRNA sequences shorter than 1400 bases,0,0
GCF_014655005.1_ASM1465500v1_genomic.gbff.gz,"Klebsiella michiganensis strain SCKM090647 contig00001, whole genome shotgun sequence",0,All rRNA sequences shorter than 1400 bases,0,0
GCF_014655015.1_ASM1465501v1_genomic.gbff.gz,"Klebsiella grimontii strain SCKG090649 contig00001, whole genome shotgun sequence",0,All rRNA sequences shorter than 1400 bases,0,0
GCF_014655075.1_ASM1465507v1_genomic.gbff.gz,"Klebsiella michiganensis strain SCKM090640 contig00001, whole genome shotgun sequence",0,All rRNA sequences shorter than 1400 bases,0,0
GCF_014655105.1_ASM1465510v1_genomic.gbff.gz,"Klebsiella michiganensis strain SCKM090631 contig00001, whole genome shotgun sequence",0,All rRNA sequences shorter than 1400 bases,0,0
GCF_014655115.1_ASM1465511v1_genomic.gbff.gz,"Klebsiella michiganensis strain SCKM090630 contig00001, whole genome shotgun sequence",0,All rRNA sequences shorter than 1400 bases,0,0
GCF_014855615.1_ASM1485561v1_genomic.gbff.gz,"Klebsiella michiganensis strain KO13459-1 plasmid pKO13459-1_KPC2, whole genome shotgun sequence",1,,1,0,1
GCF_014855615.2_ASM1485561v2_genomic.gbff.gz,"Klebsiella michiganensis strain KO13459-1 plasmid pKM_13459-1_KPC2, whole genome shotgun sequence",1,,1,0,1
GCF_014856135.1_ASM1485613v1_genomic.gbff.gz,"Klebsiella michiganensis strain KO16290 plasmid pKO16290_KPC2, whole genome shotgun sequence",1,,1,0,1
GCF_014856145.1_ASM1485614v1_genomic.gbff.gz,"Klebsiella michiganensis strain KO17045 plasmid pKO17045_KPC2, whole genome shotgun sequence",1,,1,0,1
GCF_014856335.1_ASM1485633v1_genomic.gbff.gz,"Klebsiella michiganensis strain KO14657 plasmid pKO14657_KPC2, whole genome shotgun sequence",1,,1,0,1
GCF_014856345.1_ASM1485634v1_genomic.gbff.gz,"Klebsiella michiganensis strain KO16162 plasmid pKO16162_KPC2, whole genome shotgun sequence",1,,1,0,1
GCF_014856365.1_ASM1485636v1_genomic.gbff.gz,"Klebsiella michiganensis strain KO13048 plasmid pKO13048_KPC2, whole genome shotgun sequence",1,,1,0,1
GCF_014856375.1_ASM1485637v1_genomic.gbff.gz,"Klebsiella michiganensis strain KO14641 plasmid pKO14641_KPC2, whole genome shotgun sequence",1,,1,0,1
GCF_014856385.1_ASM1485638v1_genomic.gbff.gz,"Klebsiella michiganensis strain KO13137a plasmid pKO13137_KPC2, whole genome shotgun sequence",1,,1,0,1
GCF_014856435.1_ASM1485643v1_genomic.gbff.gz,"Klebsiella michiganensis strain KO13047 plasmid pKO13047_KPC2, whole genome shotgun sequence",1,,1,0,1
GCF_014901955.1_ASM1490195v1_genomic.gbff.gz,"Klebsiella grimontii strain UCICRE-146 scaffold00001, whole genome shotgun sequence",1,,1,0,1
GCF_015074825.1_ASM1507482v1_genomic.gbff.gz,"Klebsiella grimontii strain M5a1 chromosome, complete genome",8,,4,4,2
GCF_015139575.1_ASM1513957v1_genomic.gbff.gz,"Klebsiella michiganensis strain THO-011 chromosome, complete genome",8,,3,5,1
GCF_015208375.1_ASM1520837v1_genomic.gbff.gz,"Klebsiella grimontii strain IN139_11 contig00001, whole genome shotgun sequence",0,No matching 16S rRNA product criteria,0,0
GCF_015265825.1_ASM1526582v1_genomic.gbff.gz,"Klebsiella oxytoca strain EC7 contig00001, whole genome shotgun sequence",1,,1,0,1
GCF_015265865.1_ASM1526586v1_genomic.gbff.gz,"Klebsiella oxytoca strain K51 contig00001, whole genome shotgun sequence",1,,1,0,1
GCF_015356395.1_ASM1535639v1_genomic.gbff.gz,"Klebsiella michiganensis strain CPE6 plasmid pA6sk3_1, whole genome shotgun sequence",8,,7,1,2
GCF_015356405.1_ASM1535640v1_genomic.gbff.gz,"Klebsiella michiganensis strain CPE5 plasmid p211DT2019_1, whole genome shotgun sequence",8,,7,1,2
GCF_015550995.1_ASM1555099v1_genomic.gbff.gz,"Klebsiella michiganensis strain 1001254B_151014_G7 NODE_10_length_232264_cov_32.9819, whole genome shotgun sequence",1,,1,0,1
GCF_015551825.1_ASM1555182v1_genomic.gbff.gz,"Klebsiella oxytoca strain 1001216B_150713_B10 NODE_10_length_237251_cov_20.6226, whole genome shotgun sequence",1,,1,0,1
GCF_015554545.1_ASM1555454v1_genomic.gbff.gz,"Klebsiella oxytoca strain 1001095A_150126_A4 NODE_10_length_202611_cov_24.3009, whole genome shotgun sequence",1,,1,0,1
GCF_015559095.1_ASM1555909v1_genomic.gbff.gz,"Klebsiella oxytoca strain 1001311H_170123_C2 NODE_10_length_204774_cov_34.9631, whole genome shotgun sequence",1,,1,0,1
GCF_015679305.1_ASM1567930v1_genomic.gbff.gz,"Klebsiella oxytoca strain 708776-17 708776-17scaffold_0001, whole genome shotgun sequence",1,,1,0,1
GCF_015679365.1_ASM1567936v1_genomic.gbff.gz,"Klebsiella michiganensis strain 401065-17 401065-17_1, whole genome shotgun sequence",0,All rRNA sequences shorter than 1400 bases,0,0
GCF_015694145.1_ASM1569414v1_genomic.gbff.gz,"Klebsiella oxytoca strain EC2 contig00003, whole genome shotgun sequence",0,All rRNA sequences shorter than 1400 bases,0,0
GCF_015721195.1_ASM1572119v1_genomic.gbff.gz,"Klebsiella oxytoca strain KLO00036 KLO00036_c0001, whole genome shotgun sequence",1,,1,0,1
GCF_015721205.1_ASM1572120v1_genomic.gbff.gz,"Klebsiella michiganensis strain KLO00038 KLO00038_c0001, whole genome shotgun sequence",0,All rRNA sequences shorter than 1400 bases,0,0
GCF_015721265.1_ASM1572126v1_genomic.gbff.gz,"Klebsiella oxytoca strain KLO00033 KLO00033_c0001, whole genome shotgun sequence",1,,1,0,1
GCF_015721285.1_ASM1572128v1_genomic.gbff.gz,"Klebsiella michiganensis strain KLO00030 KLO00030_c0001, whole genome shotgun sequence",1,,1,0,1
GCF_015721295.1_ASM1572129v1_genomic.gbff.gz,"Klebsiella oxytoca strain KLO00028 KLO00028_c0001, whole genome shotgun sequence",1,,1,0,1
GCF_015721325.1_ASM1572132v1_genomic.gbff.gz,"Klebsiella michiganensis strain KLO00031 KLO00031_c0001, whole genome shotgun sequence",1,,1,0,1
GCF_015721335.1_ASM1572133v1_genomic.gbff.gz,"Klebsiella michiganensis strain KLO00029 KLO00029_c0001, whole genome shotgun sequence",0,All rRNA sequences shorter than 1400 bases,0,0
GCF_015721345.1_ASM1572134v1_genomic.gbff.gz,"Klebsiella oxytoca strain KLO00026 KLO00026_c0001, whole genome shotgun sequence",1,,1,0,1
GCF_015721385.1_ASM1572138v1_genomic.gbff.gz,"Klebsiella oxytoca strain KLO00027 KLO00027_c0001, whole genome shotgun sequence",1,,1,0,1
GCF_015721405.1_ASM1572140v1_genomic.gbff.gz,"Klebsiella oxytoca strain KLO00024 KLO00024_c0001, whole genome shotgun sequence",1,,1,0,1
GCF_015721425.1_ASM1572142v1_genomic.gbff.gz,"Klebsiella michiganensis strain KLO00019 KLO00019_c0001, whole genome shotgun sequence",1,,1,0,1
GCF_015721435.1_ASM1572143v1_genomic.gbff.gz,"Klebsiella michiganensis strain KLO00023 1, whole genome shotgun sequence",8,,5,3,1
GCF_015721445.1_ASM1572144v1_genomic.gbff.gz,"Klebsiella michiganensis strain KLO00020 KLO00020_c0001, whole genome shotgun sequence",0,All rRNA sequences shorter than 1400 bases,0,0
GCF_015721485.1_ASM1572148v1_genomic.gbff.gz,"Klebsiella michiganensis strain KLO00018 KLO00018_contig00001, whole genome shotgun sequence",1,,1,0,1
GCF_015721495.1_ASM1572149v1_genomic.gbff.gz,"Klebsiella oxytoca strain KLO00017 KLO00017_c0001, whole genome shotgun sequence",8,,8,0,1
GCF_015721525.1_ASM1572152v1_genomic.gbff.gz,"Klebsiella michiganensis strain KLO00016 KLO00016_contig00001, whole genome shotgun sequence",0,All rRNA sequences shorter than 1400 bases,0,0
GCF_015721545.1_ASM1572154v1_genomic.gbff.gz,"Klebsiella michiganensis strain KLO00015 1, whole genome shotgun sequence",8,,8,0,1
GCF_015721555.1_ASM1572155v1_genomic.gbff.gz,"Klebsiella oxytoca strain KLO00014 contig00001, whole genome shotgun sequence",1,,1,0,1
GCF_015721585.1_ASM1572158v1_genomic.gbff.gz,"Klebsiella michiganensis strain KLO00012 contig00001, whole genome shotgun sequence",1,,1,0,1
GCF_015721605.1_ASM1572160v1_genomic.gbff.gz,"Klebsiella michiganensis strain KLO00013 contig00001, whole genome shotgun sequence",1,,1,0,1
GCF_015721625.1_ASM1572162v1_genomic.gbff.gz,"Klebsiella michiganensis strain KLO00011 contig00001, whole genome shotgun sequence",1,,1,0,1
GCF_015721645.1_ASM1572164v1_genomic.gbff.gz,"Klebsiella michiganensis strain KLO00010 contig00001, whole genome shotgun sequence",1,,1,0,1
GCF_015721655.1_ASM1572165v1_genomic.gbff.gz,"Klebsiella oxytoca strain KLO00008 contig00001, whole genome shotgun sequence",1,,1,0,1
GCF_015721685.1_ASM1572168v1_genomic.gbff.gz,"Klebsiella oxytoca strain KLO00007 contig00001, whole genome shotgun sequence",0,All rRNA sequences shorter than 1400 bases,0,0
GCF_015721705.1_ASM1572170v1_genomic.gbff.gz,"Klebsiella oxytoca strain KLO00006 contig00001, whole genome shotgun sequence",1,,1,0,1
GCF_015721725.1_ASM1572172v1_genomic.gbff.gz,"Klebsiella oxytoca strain KLO00003 1, whole genome shotgun sequence",8,,8,0,1
GCF_015721745.1_ASM1572174v1_genomic.gbff.gz,"Klebsiella michiganensis strain KLO00005 contig00001, whole genome shotgun sequence",1,,1,0,1
GCF_015721755.1_ASM1572175v1_genomic.gbff.gz,"Klebsiella oxytoca strain KLO00001 contig00001, whole genome shotgun sequence",1,,1,0,1
GCF_015773165.1_ASM1577316v1_genomic.gbff.gz,"Klebsiella michiganensis strain Lac4 NODE_100_length_294_cov_211.723077, whole genome shotgun sequence",1,,1,0,1
GCF_015999385.1_ASM1599938v1_genomic.gbff.gz,"Klebsiella michiganensis strain 7525 chromosome, complete genome",8,,8,0,1
GCF_016529765.1_ASM1652976v1_genomic.gbff.gz,"Klebsiella oxytoca strain 1-22 NODE_100_length_300_cov_84.394619, whole genome shotgun sequence",1,,1,0,1
GCF_016618215.1_ASM1661821v1_genomic.gbff.gz,"Klebsiella michiganensis strain BD-50-Km chromosome, complete genome",8,,4,4,2
GCF_016620455.1_ASM1662045v1_genomic.gbff.gz,"Klebsiella michiganensis strain H08 Klebsiella_contig_1, whole genome shotgun sequence",0,All rRNA sequences shorter than 1400 bases,0,0
GCF_016636025.1_ASM1663602v1_genomic.gbff.gz,"Klebsiella oxytoca strain KO57_H NODE_100_length_315_cov_1.105932_pilon, whole genome shotgun sequence",1,,1,0,1
GCF_016636045.1_ASM1663604v1_genomic.gbff.gz,"Klebsiella oxytoca strain KO52_H NODE_100_length_359_cov_17.828571_pilon, whole genome shotgun sequence",1,,1,0,1
GCF_016636055.1_ASM1663605v1_genomic.gbff.gz,"Klebsiella oxytoca strain KO105_C NODE_100_length_363_cov_18.330986_pilon, whole genome shotgun sequence",1,,1,0,1
GCF_016636085.1_ASM1663608v1_genomic.gbff.gz,"Klebsiella oxytoca strain KO104_H NODE_100_length_479_cov_1.507500_pilon, whole genome shotgun sequence",1,,1,0,1
GCF_016636105.1_ASM1663610v1_genomic.gbff.gz,"Klebsiella oxytoca strain KO19_H NODE_100_length_334_cov_0.819608_pilon, whole genome shotgun sequence",1,,1,0,1
GCF_016636135.1_ASM1663613v1_genomic.gbff.gz,"Klebsiella oxytoca strain KO39_H NODE_100_length_630_cov_1.000000_pilon, whole genome shotgun sequence",1,,1,0,1
GCF_016636165.1_ASM1663616v1_genomic.gbff.gz,"Klebsiella oxytoca strain KO31_C NODE_100_length_319_cov_46.779167_pilon, whole genome shotgun sequence",1,,1,0,1
GCF_016643945.1_ASM1664394v1_genomic.gbff.gz,"Klebsiella oxytoca strain 2-52 NODE_100_length_258_cov_0.817680, whole genome shotgun sequence",0,All rRNA sequences shorter than 1400 bases,0,0
GCF_016652915.1_ASM1665291v1_genomic.gbff.gz,"Klebsiella michiganensis strain KA43_C NODE_100_length_1162_cov_1.318560_pilon, whole genome shotgun sequence",1,,1,0,1
GCF_016652925.1_ASM1665292v1_genomic.gbff.gz,"Klebsiella michiganensis strain KO99_C NODE_100_length_384_cov_0.849180_pilon, whole genome shotgun sequence",1,,1,0,1
GCF_016652965.1_ASM1665296v1_genomic.gbff.gz,"Klebsiella michiganensis strain KO66_H NODE_100_length_380_cov_0.877076_pilon, whole genome shotgun sequence",1,,1,0,1
GCF_016652995.1_ASM1665299v1_genomic.gbff.gz,"Klebsiella michiganensis strain KO12_C NODE_100_length_389_cov_0.890323_pilon, whole genome shotgun sequence",1,,1,0,1
GCF_016653015.1_ASM1665301v1_genomic.gbff.gz,"Klebsiella michiganensis strain KO70_H NODE_100_length_337_cov_1.065891_pilon, whole genome shotgun sequence",1,,1,0,1
GCF_016653035.1_ASM1665303v1_genomic.gbff.gz,"Klebsiella michiganensis strain KO36_C NODE_100_length_17155_cov_4.905774_pilon, whole genome shotgun sequence",1,,1,0,1
GCF_016653045.1_ASM1665304v1_genomic.gbff.gz,"Klebsiella grimontii strain KO10_C NODE_1000_length_352_cov_0.974359_pilon, whole genome shotgun sequence",1,,1,0,1
GCF_016653085.1_ASM1665308v1_genomic.gbff.gz,"Klebsiella michiganensis strain KO7_H NODE_100_length_411_cov_17.322289_pilon, whole genome shotgun sequence",1,,1,0,1
GCF_016656825.1_ASM1665682v1_genomic.gbff.gz,Klebsiella grimontii strain KOX 60 chromosome,7,,7,0,3
GCF_016679895.1_KLEB011_genomic.gbff.gz,"Klebsiella michiganensis strain KLEB011 1, whole genome shotgun sequence",1,,1,0,1
GCF_016734915.1_ASM1673491v1_genomic.gbff.gz,"Klebsiella michiganensis strain KLEB016 1, whole genome shotgun sequence",1,,1,0,1
GCF_016734965.1_ASM1673496v1_genomic.gbff.gz,"Klebsiella michiganensis strain KLEB015 1, whole genome shotgun sequence",1,,1,0,1
GCF_016734995.1_ASM1673499v1_genomic.gbff.gz,"Klebsiella oxytoca strain KLEB012 1, whole genome shotgun sequence",1,,1,0,1
GCF_016735005.1_ASM1673500v1_genomic.gbff.gz,"Klebsiella michiganensis strain KLEB014 1, whole genome shotgun sequence",0,All rRNA sequences shorter than 1400 bases,0,0
GCF_016772995.1_ASM1677299v1_genomic.gbff.gz,"Klebsiella michiganensis strain CPO116 1, whole genome shotgun sequence",8,,8,0,1
GCF_016773035.1_ASM1677303v1_genomic.gbff.gz,"Klebsiella oxytoca strain CPO119 1, whole genome shotgun sequence",8,,8,0,1
GCF_016773175.1_ASM1677317v1_genomic.gbff.gz,"Klebsiella oxytoca strain CPO082 1, whole genome shotgun sequence",8,,8,0,1
GCF_016774035.1_ASM1677403v1_genomic.gbff.gz,"Klebsiella oxytoca strain CPO118 1, whole genome shotgun sequence",8,,8,0,1
GCF_016774075.1_ASM1677407v1_genomic.gbff.gz,"Klebsiella oxytoca strain CPO121 1, whole genome shotgun sequence",8,,8,0,1
GCF_016774315.1_ASM1677431v1_genomic.gbff.gz,"Klebsiella oxytoca strain CPO088 1, whole genome shotgun sequence",8,,8,0,1
GCF_016811025.1_ASM1681102v1_genomic.gbff.gz,"Klebsiella grimontii strain AT013-Mero-001 NODE_100_length_3197_cov_5.972436, whole genome shotgun sequence",0,All rRNA sequences shorter than 1400 bases,0,0
GCF_016903415.1_ASM1690341v1_genomic.gbff.gz,"Klebsiella oxytoca strain FDAARGOS_1334 chromosome, complete genome",8,,2,6,2
GCF_016903715.1_ASM1690371v1_genomic.gbff.gz,"Klebsiella oxytoca strain FDAARGOS_1332 chromosome, complete genome",8,,7,1,3
GCF_016903975.1_ASM1690397v1_genomic.gbff.gz,"Klebsiella oxytoca strain FDAARGOS_1333 chromosome, complete genome",8,,5,3,1
GCF_016904515.1_ASM1690451v1_genomic.gbff.gz,"Klebsiella oxytoca strain FDAARGOS_1331 chromosome, complete genome",8,,6,2,2
GCF_016905825.1_ASM1690582v1_genomic.gbff.gz,"Klebsiella michiganensis strain KO46817 NODE_100_length_17254_cov_22.952648, whole genome shotgun sequence",0,All rRNA sequences shorter than 1400 bases,0,0
GCF_016918825.1_ASM1691882v1_genomic.gbff.gz,"Klebsiella oxytoca strain FDAARGOS_1336 chromosome, whole genome shotgun sequence",8,,4,4,1
GCF_017114595.1_ASM1711459v1_genomic.gbff.gz,"Klebsiella michiganensis strain KO45182 plasmid unnamed1, whole genome shotgun sequence",8,,6,2,3
GCF_017310465.1_ASM1731046v1_genomic.gbff.gz,"Klebsiella oxytoca strain IR5392 chromosome, complete genome",8,,5,3,2
GCF_017348855.1_ASM1734885v1_genomic.gbff.gz,"Klebsiella michiganensis strain Kmfe267 chromosome, complete genome",8,,8,0,1
GCF_017639895.1_ASM1763989v1_genomic.gbff.gz,"Klebsiella michiganensis strain 12084 chromosome, complete genome",8,,7,1,2
GCF_017798285.1_ASM1779828v1_genomic.gbff.gz,"Klebsiella michiganensis strain LDS17 chromosome, complete genome",8,,3,5,3
GCF_017810085.1_ASM1781008v1_genomic.gbff.gz,"Klebsiella michiganensis strain ET24 NODE_100_length_255_cov_72.085938, whole genome shotgun sequence",1,,1,0,1
GCF_017815775.1_ASM1781577v1_genomic.gbff.gz,"Klebsiella michiganensis strain X2-1 chromosome, complete genome",8,,7,1,3
GCF_017863855.1_ASM1786385v1_genomic.gbff.gz,"Klebsiella grimontii strain 2481359 chromosome, complete genome",8,,8,0,1
GCF_017863935.1_ASM1786393v1_genomic.gbff.gz,"Klebsiella grimontii strain 5512.56 chromosome, complete genome",8,,8,0,1
GCF_017968865.1_ASM1796886v1_genomic.gbff.gz,"Klebsiella oxytoca isolate KoPF10 chromosome, complete genome",8,,7,1,2
GCF_017974245.1_ASM1797424v1_genomic.gbff.gz,"Klebsiella oxytoca strain ISMETTKLB165 NODE_10_length_176991_cov_47.6485_ID_20519, whole genome shotgun sequence",1,,1,0,1
GCF_018068785.1_ASM1806878v1_genomic.gbff.gz,"Klebsiella oxytoca strain 2020EL-00037 NODE_100_length_3392_cov_24.913629, whole genome shotgun sequence",0,All rRNA sequences shorter than 1400 bases,0,0
GCF_018092585.1_ASM1809258v1_genomic.gbff.gz,"Klebsiella michiganensis strain 20-MO00090-0 20-MO00090-0_KlebKlinAbwUBo_contig_1, whole genome shotgun sequence",1,,1,0,1
GCF_018092635.1_ASM1809263v1_genomic.gbff.gz,"Klebsiella michiganensis strain 20-MO00090-1 20-MO00090-1_KlebKlinAbwUBo_contig_1, whole genome shotgun sequence",1,,1,0,1
GCF_018138395.1_ASM1813839v1_genomic.gbff.gz,"Klebsiella michiganensis strain SCPM-O-B-9255 (F28-4Ko/19) 1, whole genome shotgun sequence",1,,1,0,1
GCF_018138465.1_ASM1813846v1_genomic.gbff.gz,"Klebsiella michiganensis strain SCPM-O-B-9252 (Z12Ko/19) 1, whole genome shotgun sequence",1,,1,0,1
GCF_018138485.1_ASM1813848v1_genomic.gbff.gz,"Klebsiella michiganensis strain SCPM-O-B-9251 (F12-4Ko/19) 1, whole genome shotgun sequence",1,,1,0,1
GCF_018138905.1_ASM1813890v1_genomic.gbff.gz,"Klebsiella oxytoca strain SCPM-O-B-9254 (Z18Ko/19) 1, whole genome shotgun sequence",1,,1,0,1
GCF_018139045.1_ASM1813904v1_genomic.gbff.gz,"Klebsiella pasteurii strain Sb-24 chromosome, complete genome",8,,6,2,2
GCF_018140945.1_ASM1814094v1_genomic.gbff.gz,"Klebsiella michiganensis strain CZ598 chromosome, complete genome",8,,5,3,2
GCF_018257735.1_ASM1825773v1_genomic.gbff.gz,"Klebsiella michiganensis strain JGM22 scaffold100_size18689, whole genome shotgun sequence",0,All rRNA sequences shorter than 1400 bases,0,0
GCF_018422065.1_ASM1842206v1_genomic.gbff.gz,"Klebsiella michiganensis strain Survcare371 Survcare371_S13_contig_1, whole genome shotgun sequence",1,,1,0,1
GCF_018422165.1_ASM1842216v1_genomic.gbff.gz,"Klebsiella michiganensis strain Survcare365 NODE_100_length_15790_cov_5.12607, whole genome shotgun sequence",1,,1,0,1
GCF_018438865.1_ASM1843886v1_genomic.gbff.gz,"Klebsiella michiganensis strain NRZ-41473 NODE_10_length_241632_cov_34.7639, whole genome shotgun sequence",1,,1,0,1
GCF_018439305.1_ASM1843930v1_genomic.gbff.gz,"Klebsiella michiganensis strain NRZ-36825 NODE_100_length_203_cov_40.7619, whole genome shotgun sequence",1,,1,0,1
GCF_018439315.1_ASM1843931v1_genomic.gbff.gz,"Klebsiella michiganensis strain NRZ-36826 NODE_100_length_1447_cov_18.6636, whole genome shotgun sequence",0,All rRNA sequences shorter than 1400 bases,0,0
GCF_018439335.1_ASM1843933v1_genomic.gbff.gz,"Klebsiella michiganensis strain NRZ-36521 NODE_10_length_232010_cov_42.287, whole genome shotgun sequence",1,,1,0,1
GCF_018439355.1_ASM1843935v1_genomic.gbff.gz,"Klebsiella michiganensis strain NRZ-36455 NODE_100_length_22067_cov_6.9382, whole genome shotgun sequence",0,All rRNA sequences shorter than 1400 bases,0,0
GCF_018439405.1_ASM1843940v1_genomic.gbff.gz,"Klebsiella michiganensis strain NRZ-36109 NODE_100_length_4635_cov_9.90639, whole genome shotgun sequence",1,,1,0,1
GCF_018440985.1_ASM1844098v1_genomic.gbff.gz,"Klebsiella michiganensis strain Survcare276 NODE_100_length_4002_cov_7.54318, whole genome shotgun sequence",1,,1,0,1
GCF_018441525.1_ASM1844152v1_genomic.gbff.gz,"Klebsiella oxytoca strain Survcare179 NODE_10_length_218562_cov_24.0544, whole genome shotgun sequence",1,,1,0,1
GCF_018442305.1_ASM1844230v1_genomic.gbff.gz,"Klebsiella michiganensis strain Survcare124 NODE_100_length_306_cov_45.3886, whole genome shotgun sequence",1,,1,0,1
GCF_018442325.1_ASM1844232v1_genomic.gbff.gz,"Klebsiella michiganensis strain Survcare126 NODE_10_length_232010_cov_47.1136, whole genome shotgun sequence",1,,1,0,1
GCF_018443125.1_ASM1844312v1_genomic.gbff.gz,"Klebsiella michiganensis strain SurvCare087 NODE_100_length_275_cov_104.783, whole genome shotgun sequence",1,,1,0,1
GCF_018443185.1_ASM1844318v1_genomic.gbff.gz,"Klebsiella oxytoca strain Survcare083-2 NODE_100_length_346_cov_100.089, whole genome shotgun sequence",1,,1,0,1
GCF_018443495.1_ASM1844349v1_genomic.gbff.gz,"Klebsiella oxytoca strain Survcare074 NODE_100_length_338_cov_104.08, whole genome shotgun sequence",1,,1,0,1
GCF_018443665.1_ASM1844366v1_genomic.gbff.gz,"Klebsiella oxytoca strain Survcare068-2 NODE_100_length_453_cov_576.888, whole genome shotgun sequence",1,,1,0,1
GCF_018443705.1_ASM1844370v1_genomic.gbff.gz,"Klebsiella oxytoca strain Survcare066-2 NODE_100_length_383_cov_80.9412, whole genome shotgun sequence",1,,1,0,1
GCF_018443785.1_ASM1844378v1_genomic.gbff.gz,"Klebsiella oxytoca strain Survcare067-2 NODE_100_length_377_cov_237.19, whole genome shotgun sequence",1,,1,0,1
GCF_018443915.1_ASM1844391v1_genomic.gbff.gz,"Klebsiella oxytoca strain Survcare063-2 NODE_100_length_377_cov_93.2567, whole genome shotgun sequence",1,,1,0,1
GCF_018443995.1_ASM1844399v1_genomic.gbff.gz,"Klebsiella oxytoca strain Survcare062-2 NODE_100_length_1331_cov_128.041, whole genome shotgun sequence",1,,1,0,1
GCF_018444055.1_ASM1844405v1_genomic.gbff.gz,"Klebsiella oxytoca strain Survcare061-2 NODE_100_length_329_cov_76.6389, whole genome shotgun sequence",1,,1,0,1
GCF_018444115.1_ASM1844411v1_genomic.gbff.gz,"Klebsiella oxytoca strain Survcare060 NODE_10_length_181966_cov_39.5363, whole genome shotgun sequence",1,,1,0,1
GCF_018444465.1_ASM1844446v1_genomic.gbff.gz,"Klebsiella oxytoca strain Survcare051-1 NODE_100_length_522_cov_50.3933, whole genome shotgun sequence",1,,1,0,1
GCF_018447075.1_ASM1844707v1_genomic.gbff.gz,"Klebsiella oxytoca strain Survcare231 NODE_100_length_488_cov_64.6205, whole genome shotgun sequence",0,All rRNA sequences shorter than 1400 bases,0,0
GCF_018604105.1_ASM1860410v1_genomic.gbff.gz,"Klebsiella michiganensis strain JNQH491 chromosome, complete genome",8,,6,2,2
GCF_019050695.1_ASM1905069v1_genomic.gbff.gz,"Klebsiella michiganensis strain xz176 10_length=264572_depth=1.08x, whole genome shotgun sequence",0,All rRNA sequences shorter than 1400 bases,0,0
GCF_019334465.1_ASM1933446v1_genomic.gbff.gz,"Klebsiella grimontii strain NY3 chromosome, complete genome",8,,6,2,1
GCF_019378535.1_ASM1937853v1_genomic.gbff.gz,Klebsiella michiganensis strain Colony483 chromosome,8,,5,3,2
GCF_019378655.1_ASM1937865v1_genomic.gbff.gz,Klebsiella michiganensis strain Colony517 chromosome,8,,5,3,2
GCF_019378695.1_ASM1937869v1_genomic.gbff.gz,Klebsiella michiganensis strain Colony351 chromosome,8,,4,4,2
GCF_019426465.1_ASM1942646v1_genomic.gbff.gz,"Klebsiella michiganensis strain CVUAS 2513.3 NODE_1, whole genome shotgun sequence",1,,1,0,1
GCF_019428105.1_ASM1942810v1_genomic.gbff.gz,"Klebsiella michiganensis strain CVUAS 2404.3 NODE_1, whole genome shotgun sequence",1,,1,0,1
GCF_019428145.1_ASM1942814v1_genomic.gbff.gz,"Klebsiella michiganensis strain CVUAS 6675.2 NODE_1, whole genome shotgun sequence",1,,1,0,1
GCF_019428225.1_ASM1942822v1_genomic.gbff.gz,"Klebsiella michiganensis strain CVUAS 9732.2 NODE_1, whole genome shotgun sequence",0,All rRNA sequences shorter than 1400 bases,0,0
GCF_019460145.1_ASM1946014v1_genomic.gbff.gz,"Klebsiella michiganensis strain K210011 NODE_100_length_2223_cov_206.161696, whole genome shotgun sequence",0,All rRNA sequences shorter than 1400 bases,0,0
GCF_019677525.1_ASM1967752v1_genomic.gbff.gz,"Klebsiella oxytoca strain CVUAS 10038.2 NODE_1, whole genome shotgun sequence",1,,1,0,1
GCF_019677765.1_ASM1967776v1_genomic.gbff.gz,"Klebsiella oxytoca strain CVUAS 11572 NODE_100_length_14414_cov_5.13761, whole genome shotgun sequence",0,All rRNA sequences shorter than 1400 bases,0,0
GCF_019677835.1_ASM1967783v1_genomic.gbff.gz,"Klebsiella grimontii strain CVUAS 11315.2 NODE_1, whole genome shotgun sequence",1,,1,0,1
GCF_019678415.1_ASM1967841v1_genomic.gbff.gz,"Klebsiella michiganensis strain CVUAS 11390 NODE_1, whole genome shotgun sequence",1,,1,0,1
GCF_019678495.1_ASM1967849v1_genomic.gbff.gz,"Klebsiella michiganensis strain CVUAS 11487 NODE_1, whole genome shotgun sequence",0,All rRNA sequences shorter than 1400 bases,0,0
GCF_019678505.1_ASM1967850v1_genomic.gbff.gz,"Klebsiella michiganensis strain CVUAS 11486 NODE_1, whole genome shotgun sequence",1,,1,0,1
GCF_019678825.1_ASM1967882v1_genomic.gbff.gz,"Klebsiella michiganensis strain CVUAS 11699 NODE_1, whole genome shotgun sequence",0,All rRNA sequences shorter than 1400 bases,0,0
GCF_019679175.1_ASM1967917v1_genomic.gbff.gz,"Klebsiella michiganensis strain CVUAS 11560.2 NODE_1, whole genome shotgun sequence",1,,1,0,1
GCF_019730455.1_ASM1973045v1_genomic.gbff.gz,"Klebsiella michiganensis strain Y18 scaf_1, whole genome shotgun sequence",1,,1,0,1
GCF_019730515.1_ASM1973051v1_genomic.gbff.gz,"Klebsiella michiganensis strain Y16 scaf_1, whole genome shotgun sequence",1,,1,0,1
GCF_019730535.1_ASM1973053v1_genomic.gbff.gz,"Klebsiella michiganensis strain Y14 scaf_1, whole genome shotgun sequence",1,,1,0,1
GCF_019730985.1_ASM1973098v1_genomic.gbff.gz,"Klebsiella michiganensis strain Y01 scaf_1, whole genome shotgun sequence",1,,1,0,1
GCF_019731925.1_ASM1973192v1_genomic.gbff.gz,"Klebsiella michiganensis strain KE4018 contig_KE4018_1, whole genome shotgun sequence",0,All rRNA sequences shorter than 1400 bases,0,0
GCF_019771925.1_ASM1977192v1_genomic.gbff.gz,"Klebsiella oxytoca strain KO-16-21 NODE_100_length_2318_cov_758.311914, whole genome shotgun sequence",1,,1,0,1
GCF_019803065.1_ASM1980306v1_genomic.gbff.gz,"Klebsiella michiganensis strain CCRI-24235 chromosome, complete genome",8,,2,6,2
GCF_019913035.1_ASM1991303v1_genomic.gbff.gz,"Klebsiella grimontii strain M5aI M5aI_contig_1, whole genome shotgun sequence",4,,2,2,2
GCF_020115135.1_ASM2011513v1_genomic.gbff.gz,"Klebsiella michiganensis strain 141125-16 141125-16_1, whole genome shotgun sequence",1,,1,0,1
GCF_020115525.1_ASM2011552v1_genomic.gbff.gz,"Klebsiella michiganensis strain DSM 103279 DSM-103279_1, whole genome shotgun sequence",1,,1,0,1
GCF_020115535.1_ASM2011553v1_genomic.gbff.gz,"Klebsiella oxytoca strain DSM 5175 DSM-5175_1, whole genome shotgun sequence",1,,1,0,1
GCF_020115715.1_ASM2011571v1_genomic.gbff.gz,"Klebsiella grimontii strain 804720-15 804720-15_1, whole genome shotgun sequence",1,,1,0,1
GCF_020116215.1_ASM2011621v1_genomic.gbff.gz,"Klebsiella michiganensis strain 800126-16 800126-16_1, whole genome shotgun sequence",0,All rRNA sequences shorter than 1400 bases,0,0
GCF_020116275.1_ASM2011627v1_genomic.gbff.gz,"Klebsiella oxytoca strain 722058-16 722058-16_1, whole genome shotgun sequence",1,,1,0,1
GCF_020116315.1_ASM2011631v1_genomic.gbff.gz,"Klebsiella michiganensis strain 720807-16 720807-16_1, whole genome shotgun sequence",1,,1,0,1
GCF_020116375.1_ASM2011637v1_genomic.gbff.gz,"Klebsiella oxytoca strain 713447-17 713447-17_1, whole genome shotgun sequence",1,,1,0,1
GCF_020116385.1_ASM2011638v1_genomic.gbff.gz,"Klebsiella oxytoca strain 713490-17 713490-17_1, whole genome shotgun sequence",1,,1,0,1
GCF_020116545.1_ASM2011654v1_genomic.gbff.gz,"Klebsiella oxytoca strain 712881-17 712881-17_1, whole genome shotgun sequence",1,,1,0,1
GCF_020116575.1_ASM2011657v1_genomic.gbff.gz,"Klebsiella oxytoca strain 711206-17 711206-17_1, whole genome shotgun sequence",1,,1,0,1
GCF_020116585.1_ASM2011658v1_genomic.gbff.gz,"Klebsiella oxytoca strain 711469-2009 711469-2009_1, whole genome shotgun sequence",1,,1,0,1
GCF_020116615.1_ASM2011661v1_genomic.gbff.gz,"Klebsiella oxytoca strain 711093-17 711093-17_1, whole genome shotgun sequence",1,,1,0,1
GCF_020116635.1_ASM2011663v1_genomic.gbff.gz,"Klebsiella oxytoca strain 711072-17 711072-17_1, whole genome shotgun sequence",0,All rRNA sequences shorter than 1400 bases,0,0
GCF_020116675.1_ASM2011667v1_genomic.gbff.gz,"Klebsiella oxytoca strain 711080-17 711080-17_1, whole genome shotgun sequence",0,All rRNA sequences shorter than 1400 bases,0,0
GCF_020116695.1_ASM2011669v1_genomic.gbff.gz,"Klebsiella grimontii strain 710455-17 710455-17_1, whole genome shotgun sequence",1,,1,0,1
GCF_020116755.1_ASM2011675v1_genomic.gbff.gz,"Klebsiella grimontii strain 710322-17 710322-17_1, whole genome shotgun sequence",1,,1,0,1
GCF_020116815.1_ASM2011681v1_genomic.gbff.gz,"Klebsiella michiganensis strain 710217-17 710217-17_1, whole genome shotgun sequence",1,,1,0,1
GCF_020116835.1_ASM2011683v1_genomic.gbff.gz,"Klebsiella oxytoca strain 709965-17 709965-17_1, whole genome shotgun sequence",1,,1,0,1
GCF_020116855.1_ASM2011685v1_genomic.gbff.gz,"Klebsiella oxytoca strain 709253-17 709253-17_1, whole genome shotgun sequence",1,,1,0,1
GCF_020116875.1_ASM2011687v1_genomic.gbff.gz,"Klebsiella oxytoca strain 709081-17 709081-17_1, whole genome shotgun sequence",0,All rRNA sequences shorter than 1400 bases,0,0
GCF_020116885.1_ASM2011688v1_genomic.gbff.gz,"Klebsiella oxytoca strain 709833-17 709833-17_1, whole genome shotgun sequence",1,,1,0,1
GCF_020116915.1_ASM2011691v1_genomic.gbff.gz,"Klebsiella oxytoca strain 708994-2009 708994-2009_1, whole genome shotgun sequence",1,,1,0,1
GCF_020116935.1_ASM2011693v1_genomic.gbff.gz,"Klebsiella michiganensis strain 707154-17 707154-17_1, whole genome shotgun sequence",1,,1,0,1
GCF_020116955.1_ASM2011695v1_genomic.gbff.gz,"Klebsiella michiganensis strain 708990-17 708990-17_1, whole genome shotgun sequence",0,All rRNA sequences shorter than 1400 bases,0,0
GCF_020116975.1_ASM2011697v1_genomic.gbff.gz,"Klebsiella oxytoca strain 708712-17 708712-17_1, whole genome shotgun sequence",1,,1,0,1
GCF_020116995.1_ASM2011699v1_genomic.gbff.gz,"Klebsiella michiganensis strain 707021-17 707021-17scaffold_0001, whole genome shotgun sequence",0,All rRNA sequences shorter than 1400 bases,0,0
GCF_020117015.1_ASM2011701v1_genomic.gbff.gz,"Klebsiella michiganensis strain 706508-16 706508-16_1, whole genome shotgun sequence",1,,1,0,1
GCF_020117035.1_ASM2011703v1_genomic.gbff.gz,"Klebsiella oxytoca strain 706127-17 706127-17_1, whole genome shotgun sequence",1,,1,0,1
GCF_020117055.1_ASM2011705v1_genomic.gbff.gz,"Klebsiella oxytoca strain 705729-17 705729-17_1, whole genome shotgun sequence",0,All rRNA sequences shorter than 1400 bases,0,0
GCF_020117075.1_ASM2011707v1_genomic.gbff.gz,"Klebsiella michiganensis strain 705849-17 705849-17_1, whole genome shotgun sequence",1,,1,0,1
GCF_020117095.1_ASM2011709v1_genomic.gbff.gz,"Klebsiella michiganensis strain 705823-17 705823-17_1, whole genome shotgun sequence",1,,1,0,1
GCF_020117115.1_ASM2011711v1_genomic.gbff.gz,"Klebsiella grimontii strain 705420-17 705420-17_1, whole genome shotgun sequence",1,,1,0,1
GCF_020117225.1_ASM2011722v1_genomic.gbff.gz,"Klebsiella oxytoca strain 701520-2009 701520-2009_1, whole genome shotgun sequence",1,,1,0,1
GCF_020117275.1_ASM2011727v1_genomic.gbff.gz,"Klebsiella oxytoca strain 700765-17 700765-17_1, whole genome shotgun sequence",1,,1,0,1
GCF_020117355.1_ASM2011735v1_genomic.gbff.gz,"Klebsiella oxytoca strain 700570-17 700570-17_1, whole genome shotgun sequence",1,,1,0,1
GCF_020117435.1_ASM2011743v1_genomic.gbff.gz,"Klebsiella grimontii strain 700466-17 700466-17_1, whole genome shotgun sequence",1,,1,0,1
GCF_020117455.1_ASM2011745v1_genomic.gbff.gz,"Klebsiella oxytoca strain 700456-16 700456-16_1, whole genome shotgun sequence",1,,1,0,1
GCF_020117465.1_ASM2011746v1_genomic.gbff.gz,"Klebsiella michiganensis strain 620286643710 620286643710_1, whole genome shotgun sequence",1,,1,0,1
GCF_020117475.1_ASM2011747v1_genomic.gbff.gz,"Klebsiella michiganensis strain 620288768518 620288768518_1, whole genome shotgun sequence",1,,1,0,1
GCF_020117515.1_ASM2011751v1_genomic.gbff.gz,"Klebsiella michiganensis strain 620285505921 620285505921_1, whole genome shotgun sequence",0,All rRNA sequences shorter than 1400 bases,0,0
GCF_020117535.1_ASM2011753v1_genomic.gbff.gz,"Klebsiella michiganensis strain 620278998915 620278998915_1, whole genome shotgun sequence",1,,1,0,1
GCF_020117545.1_ASM2011754v1_genomic.gbff.gz,"Klebsiella michiganensis strain 620286429714 620286429714_1, whole genome shotgun sequence",1,,1,0,1
GCF_020117575.1_ASM2011757v1_genomic.gbff.gz,"Klebsiella grimontii strain 620279031217 620279031217_1, whole genome shotgun sequence",1,,1,0,1
GCF_020117595.1_ASM2011759v1_genomic.gbff.gz,"Klebsiella michiganensis strain 620277132808 620277132808_1, whole genome shotgun sequence",1,,1,0,1
GCF_020117615.1_ASM2011761v1_genomic.gbff.gz,"Klebsiella grimontii strain 620273821510-17 620273821510-17_1, whole genome shotgun sequence",1,,1,0,1
GCF_020117635.1_ASM2011763v1_genomic.gbff.gz,"Klebsiella grimontii strain 620271411010-17 620271411010-17_1, whole genome shotgun sequence",1,,1,0,1
GCF_020117655.1_ASM2011765v1_genomic.gbff.gz,"Klebsiella michiganensis strain 620267602911 620267602911_1, whole genome shotgun sequence",1,,1,0,1
GCF_020117665.1_ASM2011766v1_genomic.gbff.gz,"Klebsiella michiganensis strain 620272244309 620272244309_1, whole genome shotgun sequence",1,,1,0,1
GCF_020117695.1_ASM2011769v1_genomic.gbff.gz,"Klebsiella michiganensis strain 620267298408 620267298408_1, whole genome shotgun sequence",0,All rRNA sequences shorter than 1400 bases,0,0
GCF_020117715.1_ASM2011771v1_genomic.gbff.gz,"Klebsiella michiganensis strain 620263865211 620263865211_1, whole genome shotgun sequence",1,,1,0,1
GCF_020117735.1_ASM2011773v1_genomic.gbff.gz,"Klebsiella michiganensis strain 620264432508 620264432508_1, whole genome shotgun sequence",1,,1,0,1
GCF_020117755.1_ASM2011775v1_genomic.gbff.gz,"Klebsiella grimontii strain 620262936017 620262936017_1, whole genome shotgun sequence",1,,1,0,1
GCF_020117775.1_ASM2011777v1_genomic.gbff.gz,"Klebsiella michiganensis strain 620262583611 620262583611_1, whole genome shotgun sequence",0,All rRNA sequences shorter than 1400 bases,0,0
GCF_020117795.1_ASM2011779v1_genomic.gbff.gz,"Klebsiella michiganensis strain 620262927814 620262927814_1, whole genome shotgun sequence",1,,1,0,1
GCF_020117815.1_ASM2011781v1_genomic.gbff.gz,"Klebsiella michiganensis strain 620262455609 620262455609_1, whole genome shotgun sequence",1,,1,0,1
GCF_020117835.1_ASM2011783v1_genomic.gbff.gz,"Klebsiella grimontii strain 620260661315 620260661315_1, whole genome shotgun sequence",1,,1,0,1
GCF_020117855.1_ASM2011785v1_genomic.gbff.gz,"Klebsiella grimontii strain 620259814713-17 620259814713-17_1, whole genome shotgun sequence",1,,1,0,1
GCF_020117865.1_ASM2011786v1_genomic.gbff.gz,"Klebsiella michiganensis strain 620260277613 620260277613_1, whole genome shotgun sequence",1,,1,0,1
GCF_020117895.1_ASM2011789v1_genomic.gbff.gz,"Klebsiella grimontii strain 620262140113 620262140113_1, whole genome shotgun sequence",1,,1,0,1
GCF_020117915.1_ASM2011791v1_genomic.gbff.gz,"Klebsiella grimontii strain 620258715808 620258715808_1, whole genome shotgun sequence",1,,1,0,1
GCF_020117935.1_ASM2011793v1_genomic.gbff.gz,"Klebsiella grimontii strain 620257851413 620257851413_1, whole genome shotgun sequence",1,,1,0,1
GCF_020117955.1_ASM2011795v1_genomic.gbff.gz,"Klebsiella michiganensis strain 620256896681 620256896681_1, whole genome shotgun sequence",1,,1,0,1
GCF_020117965.1_ASM2011796v1_genomic.gbff.gz,"Klebsiella grimontii strain 620256532320 620256532320_1, whole genome shotgun sequence",1,,1,0,1
GCF_020117975.1_ASM2011797v1_genomic.gbff.gz,"Klebsiella grimontii strain 620255534809-17 620255534809-17_1, whole genome shotgun sequence",1,,1,0,1
GCF_020118015.1_ASM2011801v1_genomic.gbff.gz,"Klebsiella grimontii strain 620206143210 620206143210_1, whole genome shotgun sequence",1,,1,0,1
GCF_020118035.1_ASM2011803v1_genomic.gbff.gz,"Klebsiella michiganensis strain 620203084113 620203084113_1, whole genome shotgun sequence",1,,1,0,1
GCF_020118135.1_ASM2011813v1_genomic.gbff.gz,"Klebsiella oxytoca strain 608815-17 608815-17_1, whole genome shotgun sequence",1,,1,0,1
GCF_020118195.1_ASM2011819v1_genomic.gbff.gz,"Klebsiella oxytoca strain 608715-17 608715-17_1, whole genome shotgun sequence",1,,1,0,1
GCF_020118215.1_ASM2011821v1_genomic.gbff.gz,"Klebsiella oxytoca strain 608668-17 608668-17_1, whole genome shotgun sequence",1,,1,0,1
GCF_020118275.1_ASM2011827v1_genomic.gbff.gz,"Klebsiella oxytoca strain 608431-17 608431-17_1, whole genome shotgun sequence",1,,1,0,1
GCF_020118315.1_ASM2011831v1_genomic.gbff.gz,"Klebsiella oxytoca strain 608110-17 608110-17_1, whole genome shotgun sequence",1,,1,0,1
GCF_020118355.1_ASM2011835v1_genomic.gbff.gz,"Klebsiella oxytoca strain 606250-17 606250-17_1, whole genome shotgun sequence",1,,1,0,1
GCF_020118395.1_ASM2011839v1_genomic.gbff.gz,"Klebsiella grimontii strain 606641-17 606641-17_1, whole genome shotgun sequence",1,,1,0,1
GCF_020118415.1_ASM2011841v1_genomic.gbff.gz,"Klebsiella michiganensis strain 605924-17 605924-17_1, whole genome shotgun sequence",1,,1,0,1
GCF_020118435.1_ASM2011843v1_genomic.gbff.gz,"Klebsiella grimontii strain 605112-17 605112-17_1, whole genome shotgun sequence",1,,1,0,1
GCF_020118455.1_ASM2011845v1_genomic.gbff.gz,"Klebsiella michiganensis strain 603572-17 603572-17_1, whole genome shotgun sequence",1,,1,0,1
GCF_020118495.1_ASM2011849v1_genomic.gbff.gz,"Klebsiella michiganensis strain 602734-17 602734-17_1, whole genome shotgun sequence",1,,1,0,1
GCF_020118535.1_ASM2011853v1_genomic.gbff.gz,"Klebsiella grimontii strain 502988-17 502988-17_1, whole genome shotgun sequence",1,,1,0,1
GCF_020118555.1_ASM2011855v1_genomic.gbff.gz,"Klebsiella michiganensis strain 505106-17 505106-17_1, whole genome shotgun sequence",0,All rRNA sequences shorter than 1400 bases,0,0
GCF_020118595.1_ASM2011859v1_genomic.gbff.gz,"Klebsiella oxytoca strain 502954-17 502954-17_1, whole genome shotgun sequence",1,,1,0,1
GCF_020118655.1_ASM2011865v1_genomic.gbff.gz,"Klebsiella michiganensis strain 502761-17 502761-17_1, whole genome shotgun sequence",1,,1,0,1
GCF_020118665.1_ASM2011866v1_genomic.gbff.gz,"Klebsiella michiganensis strain 502790-17 502790-17_1, whole genome shotgun sequence",0,All rRNA sequences shorter than 1400 bases,0,0
GCF_020118775.1_ASM2011877v1_genomic.gbff.gz,"Klebsiella oxytoca strain 502573-2009 502573-2009_1, whole genome shotgun sequence",1,,1,0,1
GCF_020118785.1_ASM2011878v1_genomic.gbff.gz,"Klebsiella oxytoca strain 502610-17 502610-17_1, whole genome shotgun sequence",1,,1,0,1
GCF_020118815.1_ASM2011881v1_genomic.gbff.gz,"Klebsiella michiganensis strain 502565-17 502565-17_1, whole genome shotgun sequence",0,All rRNA sequences shorter than 1400 bases,0,0
GCF_020118875.1_ASM2011887v1_genomic.gbff.gz,"Klebsiella grimontii strain 502310-17 502310-17_1, whole genome shotgun sequence",1,,1,0,1
GCF_020118915.1_ASM2011891v1_genomic.gbff.gz,"Klebsiella michiganensis strain 501671-17 501671-17_1, whole genome shotgun sequence",1,,1,0,1
GCF_020118955.1_ASM2011895v1_genomic.gbff.gz,"Klebsiella michiganensis strain 500137-17 500137-17_1, whole genome shotgun sequence",1,,1,0,1
GCF_020119035.1_ASM2011903v1_genomic.gbff.gz,"Klebsiella grimontii strain 500013-17 500013-17_1, whole genome shotgun sequence",1,,1,0,1
GCF_020119055.1_ASM2011905v1_genomic.gbff.gz,"Klebsiella michiganensis strain 44-2360-1 44-2360-1_scaffold_0001, whole genome shotgun sequence",0,All rRNA sequences shorter than 1400 bases,0,0
GCF_020119115.1_ASM2011911v1_genomic.gbff.gz,"Klebsiella oxytoca strain 404821-16 404821-16_1, whole genome shotgun sequence",1,,1,0,1
GCF_020119125.1_ASM2011912v1_genomic.gbff.gz,"Klebsiella oxytoca strain 404813-5-17 404813-5-17_1, whole genome shotgun sequence",1,,1,0,1
GCF_020119845.1_ASM2011984v1_genomic.gbff.gz,"Klebsiella grimontii strain 402620-12 402620-12_1, whole genome shotgun sequence",1,,1,0,1
GCF_020119895.1_ASM2011989v1_genomic.gbff.gz,"Klebsiella grimontii strain 402496-14 402496-14_1, whole genome shotgun sequence",1,,1,0,1
GCF_020120175.1_ASM2012017v1_genomic.gbff.gz,"Klebsiella michiganensis strain 401153-17 401153-17_1, whole genome shotgun sequence",0,All rRNA sequences shorter than 1400 bases,0,0
GCF_020120515.1_ASM2012051v1_genomic.gbff.gz,"Klebsiella oxytoca strain 400125-17 400125-17_1, whole genome shotgun sequence",1,,1,0,1
GCF_020120535.1_ASM2012053v1_genomic.gbff.gz,"Klebsiella oxytoca strain 400086-17 400086-17_1, whole genome shotgun sequence",1,,1,0,1
GCF_020120585.1_ASM2012058v1_genomic.gbff.gz,"Klebsiella michiganensis strain 400041-17 400041-17_1, whole genome shotgun sequence",1,,1,0,1
GCF_020120615.1_ASM2012061v1_genomic.gbff.gz,"Klebsiella grimontii strain 40-2021-2 40-2021-2_1, whole genome shotgun sequence",1,,1,0,1
GCF_020120815.1_ASM2012081v1_genomic.gbff.gz,"Klebsiella grimontii strain 170079723-17 170079723-17_1, whole genome shotgun sequence",1,,1,0,1
GCF_020120845.1_ASM2012084v1_genomic.gbff.gz,"Klebsiella grimontii strain 170096690-17 170096690-17_scaffold_0001, whole genome shotgun sequence",0,All rRNA sequences shorter than 1400 bases,0,0
GCF_020120855.1_ASM2012085v1_genomic.gbff.gz,"Klebsiella grimontii strain 170067317-17 170067317-17_1, whole genome shotgun sequence",1,,1,0,1
GCF_020120895.1_ASM2012089v1_genomic.gbff.gz,"Klebsiella michiganensis strain 170070391-17 170070391-17_scaffold_0001, whole genome shotgun sequence",0,All rRNA sequences shorter than 1400 bases,0,0
GCF_020121095.1_ASM2012109v1_genomic.gbff.gz,"Klebsiella michiganensis strain 128489-17 128489-17_1, whole genome shotgun sequence",1,,1,0,1
GCF_020121115.1_ASM2012111v1_genomic.gbff.gz,"Klebsiella michiganensis strain 126192-17 126192-17_1, whole genome shotgun sequence",1,,1,0,1
GCF_020121285.1_ASM2012128v1_genomic.gbff.gz,"Klebsiella michiganensis strain 111734-17 111734-17_1, whole genome shotgun sequence",0,All rRNA sequences shorter than 1400 bases,0,0
GCF_020121435.1_ASM2012143v1_genomic.gbff.gz,"Klebsiella michiganensis strain 109680-17 109680-17_1, whole genome shotgun sequence",1,,1,0,1
GCF_020479545.1_ASM2047954v1_genomic.gbff.gz,"Klebsiella grimontii strain BEITU-N349 573.28525.con.0001, whole genome shotgun sequence",1,,1,0,1
GCF_020479805.1_ASM2047980v1_genomic.gbff.gz,"Klebsiella michiganensis strain BEITU-N172 573.28529.con.0001, whole genome shotgun sequence",1,,1,0,1
GCF_020695625.1_ASM2069562v1_genomic.gbff.gz,"Klebsiella michiganensis strain 53828CZ chromosome, complete genome",8,,7,1,2
GCF_021165695.1_ASM2116569v1_genomic.gbff.gz,"Klebsiella michiganensis strain CFS0697 NODE_100_length_19664_cov_29.678303, whole genome shotgun sequence",0,All rRNA sequences shorter than 1400 bases,0,0
GCF_021228185.1_ASM2122818v1_genomic.gbff.gz,"Klebsiella oxytoca strain CFI_080_KPC2 CHD Contig1, whole genome shotgun sequence",0,No matching 16S rRNA product criteria,0,0
GCF_021228655.1_ASM2122865v1_genomic.gbff.gz,"Klebsiella oxytoca strain Kox71 chromosome, complete genome",8,,4,4,3
GCF_021228695.1_ASM2122869v1_genomic.gbff.gz,"Klebsiella michiganensis strain Kox58 chromosome, complete genome",8,,6,2,5
GCF_021228715.1_ASM2122871v1_genomic.gbff.gz,"Klebsiella oxytoca strain Kox26 chromosome, complete genome",8,,5,3,2
GCF_021228735.1_ASM2122873v1_genomic.gbff.gz,"Klebsiella pasteurii strain Kox205 chromosome, complete genome",8,,7,1,4
GCF_021228775.1_ASM2122877v1_genomic.gbff.gz,"Klebsiella oxytoca strain Kox100 chromosome, complete genome",8,,4,4,2
GCF_021228855.1_ASM2122885v1_genomic.gbff.gz,"Klebsiella michiganensis strain K92 chromosome, complete genome",8,,8,0,1
GCF_021228995.1_ASM2122899v1_genomic.gbff.gz,"Klebsiella michiganensis strain 8-1 chromosome, complete genome",8,,8,0,1
GCF_021264605.1_ASM2126460v1_genomic.gbff.gz,"Klebsiella oxytoca strain KPN101 NODE_100_length_1931_cov_11.6846, whole genome shotgun sequence",1,,1,0,1
GCF_021373355.1_ASM2137335v1_genomic.gbff.gz,"Klebsiella oxytoca strain MVC303 contig00001, whole genome shotgun sequence",1,,1,0,1
GCF_021373415.1_ASM2137341v1_genomic.gbff.gz,"Klebsiella oxytoca strain MVC642 contig00001, whole genome shotgun sequence",0,All rRNA sequences shorter than 1400 bases,0,0
GCF_021391575.1_ASM2139157v1_genomic.gbff.gz,"Klebsiella michiganensis strain KM41 chromosome, complete genome",8,,7,1,2
GCF_021394645.1_ASM2139464v1_genomic.gbff.gz,"Klebsiella michiganensis strain A2 NODE_1, whole genome shotgun sequence",0,All rRNA sequences shorter than 1400 bases,0,0
GCF_021398915.1_ASM2139891v1_genomic.gbff.gz,"Klebsiella oxytoca strain KONSF-1 chromosome, complete genome",8,,7,1,1
GCF_021440665.1_ASM2144066v1_genomic.gbff.gz,"Klebsiella michiganensis strain INSAq73 Aq73_contig_1, whole genome shotgun sequence",1,,1,0,1
GCF_021460075.1_ASM2146007v1_genomic.gbff.gz,Klebsiella michiganensis strain MIN-086 chromosome,8,,7,1,1
GCF_022014295.1_ASM2201429v1_genomic.gbff.gz,"Klebsiella grimontii strain TD1 Scaffold1, whole genome shotgun sequence",0,No 16S rRNA sequences found,0,0
GCF_022163245.1_ASM2216324v1_genomic.gbff.gz,"Klebsiella michiganensis strain KO_408 chromosome, complete genome",8,,8,0,1
GCF_022163245.2_ASM2216324v2_genomic.gbff.gz,"Klebsiella michiganensis strain KO_408 chromosome, complete genome",8,,2,6,2
GCF_022343245.1_ASM2234324v1_genomic.gbff.gz,"Klebsiella michiganensis strain YL6-1 chromosome, complete genome",8,,5,3,1
GCF_022343265.1_ASM2234326v1_genomic.gbff.gz,"Klebsiella michiganensis strain YL9 chromosome, complete genome",8,,8,0,1
GCF_022359805.1_ASM2235980v1_genomic.gbff.gz,"Klebsiella michiganensis strain B199A contig00001, whole genome shotgun sequence",1,,1,0,1
GCF_022501085.1_ASM2250108v1_genomic.gbff.gz,"Klebsiella michiganensis strain E5 contig00001, whole genome shotgun sequence",0,All rRNA sequences shorter than 1400 bases,0,0
GCF_022501105.1_ASM2250110v1_genomic.gbff.gz,"Klebsiella michiganensis strain E2 contig00001, whole genome shotgun sequence",1,,1,0,1
GCF_022539825.1_ASM2253982v1_genomic.gbff.gz,"Klebsiella michiganensis strain AGK0680 1, whole genome shotgun sequence",0,All rRNA sequences shorter than 1400 bases,0,0
GCF_022539845.1_ASM2253984v1_genomic.gbff.gz,"Klebsiella grimontii strain AGK0678 1, whole genome shotgun sequence",1,,1,0,1
GCF_022539865.1_ASM2253986v1_genomic.gbff.gz,"Klebsiella michiganensis strain AGK0675 1, whole genome shotgun sequence",0,All rRNA sequences shorter than 1400 bases,0,0
GCF_022539885.1_ASM2253988v1_genomic.gbff.gz,"Klebsiella michiganensis strain AGK0677 1, whole genome shotgun sequence",0,All rRNA sequences shorter than 1400 bases,0,0
GCF_022539905.1_ASM2253990v1_genomic.gbff.gz,"Klebsiella michiganensis strain AGK0674 1, whole genome shotgun sequence",0,All rRNA sequences shorter than 1400 bases,0,0
GCF_022539995.1_ASM2253999v1_genomic.gbff.gz,"Klebsiella grimontii strain AGK0664 1, whole genome shotgun sequence",0,All rRNA sequences shorter than 1400 bases,0,0
GCF_022540065.1_ASM2254006v1_genomic.gbff.gz,"Klebsiella michiganensis strain AGK0643 1, whole genome shotgun sequence",0,All rRNA sequences shorter than 1400 bases,0,0
GCF_022540085.1_ASM2254008v1_genomic.gbff.gz,"Klebsiella michiganensis strain AGK0615 1, whole genome shotgun sequence",0,All rRNA sequences shorter than 1400 bases,0,0
GCF_022540125.1_ASM2254012v1_genomic.gbff.gz,"Klebsiella michiganensis strain AGK0577 1, whole genome shotgun sequence",0,All rRNA sequences shorter than 1400 bases,0,0
GCF_022540165.1_ASM2254016v1_genomic.gbff.gz,"Klebsiella grimontii strain AGK0505 1, whole genome shotgun sequence",0,All rRNA sequences shorter than 1400 bases,0,0
GCF_022543535.1_ASM2254353v1_genomic.gbff.gz,"Klebsiella michiganensis strain AGK0636 1, whole genome shotgun sequence",0,All rRNA sequences shorter than 1400 bases,0,0
GCF_022543575.1_ASM2254357v1_genomic.gbff.gz,"Klebsiella michiganensis strain AGK0631 1, whole genome shotgun sequence",0,All rRNA sequences shorter than 1400 bases,0,0
GCF_022543595.1_ASM2254359v1_genomic.gbff.gz,"Klebsiella michiganensis strain AGK0616 10, whole genome shotgun sequence",0,All rRNA sequences shorter than 1400 bases,0,0
GCF_022543625.1_ASM2254362v1_genomic.gbff.gz,"Klebsiella michiganensis strain AGK0587 1, whole genome shotgun sequence",0,All rRNA sequences shorter than 1400 bases,0,0
GCF_022543655.1_ASM2254365v1_genomic.gbff.gz,"Klebsiella grimontii strain AGK0556 1, whole genome shotgun sequence",1,,1,0,1
GCF_022543695.1_ASM2254369v1_genomic.gbff.gz,"Klebsiella michiganensis strain AGK0541 1, whole genome shotgun sequence",0,All rRNA sequences shorter than 1400 bases,0,0
GCF_022543715.1_ASM2254371v1_genomic.gbff.gz,"Klebsiella grimontii strain AGK0569 1, whole genome shotgun sequence",1,,1,0,1
GCF_022543725.1_ASM2254372v1_genomic.gbff.gz,"Klebsiella grimontii strain AGK0542 1, whole genome shotgun sequence",1,,1,0,1
GCF_022543755.1_ASM2254375v1_genomic.gbff.gz,"Klebsiella grimontii strain AGK0540 1, whole genome shotgun sequence",1,,1,0,1
GCF_022543775.1_ASM2254377v1_genomic.gbff.gz,"Klebsiella grimontii strain AGK0511 1, whole genome shotgun sequence",1,,1,0,1
GCF_022543785.1_ASM2254378v1_genomic.gbff.gz,"Klebsiella michiganensis strain AGK0531 1, whole genome shotgun sequence",0,All rRNA sequences shorter than 1400 bases,0,0
GCF_022543815.1_ASM2254381v1_genomic.gbff.gz,"Klebsiella michiganensis strain AGK0525 1, whole genome shotgun sequence",0,All rRNA sequences shorter than 1400 bases,0,0
GCF_022543855.1_ASM2254385v1_genomic.gbff.gz,"Klebsiella michiganensis strain AGK0510 1, whole genome shotgun sequence",0,All rRNA sequences shorter than 1400 bases,0,0
GCF_022556395.1_ASM2255639v1_genomic.gbff.gz,"Klebsiella grimontii strain KO_1 Scaffold1, whole genome shotgun sequence",0,No 16S rRNA sequences found,0,0
GCF_022559855.1_ASM2255985v1_genomic.gbff.gz,"Klebsiella grimontii strain LC-1303-2020 chromosome, complete genome",8,,8,0,1
GCF_022569835.1_ASM2256983v1_genomic.gbff.gz,"Klebsiella michiganensis strain K342 chromosome, complete genome",8,,8,0,1
GCF_022605305.1_ASM2260530v1_genomic.gbff.gz,"Klebsiella oxytoca strain C-21-18 chromosome, complete genome",8,,8,0,1
GCF_022685985.1_ASM2268598v2_genomic.gbff.gz,"Klebsiella oxytoca strain 2022EL-00172 NODE_100_length_5102_cov_10.712362, whole genome shotgun sequence",1,,1,0,1
GCF_022859475.1_ASM2285947v1_genomic.gbff.gz,"Klebsiella michiganensis strain KP89378 contig1, whole genome shotgun sequence",0,All rRNA sequences shorter than 1400 bases,0,0
GCF_022869885.1_ASM2286988v1_genomic.gbff.gz,"Klebsiella michiganensis strain fxq chromosome, complete genome",8,,7,1,2
GCF_023093655.1_ASM2309365v1_genomic.gbff.gz,"Klebsiella michiganensis strain CCBH27439 1, whole genome shotgun sequence",1,,1,0,1
GCF_023093835.1_ASM2309383v1_genomic.gbff.gz,"Klebsiella michiganensis strain K254 chromosome, complete genome",8,,8,0,1
GCF_023502385.1_ASM2350238v1_genomic.gbff.gz,"Klebsiella michiganensis strain KPN166 KPN166_ctg0001, whole genome shotgun sequence",0,All rRNA sequences shorter than 1400 bases,0,0
GCF_023572405.1_ASM2357240v1_genomic.gbff.gz,"Klebsiella oxytoca strain CCBH28636 1, whole genome shotgun sequence",1,,1,0,1
GCF_024224355.1_ASM2422435v1_genomic.gbff.gz,"Klebsiella grimontii strain LH87-a chromosome, complete genome",8,,6,2,1
GCF_024225115.1_ASM2422511v1_genomic.gbff.gz,"Klebsiella michiganensis strain LH71 chromosome, complete genome",8,,8,0,3
GCF_024396595.1_ASM2439659v1_genomic.gbff.gz,"Klebsiella michiganensis strain HOBD-7 chromosome, complete genome",8,,7,1,3
GCF_024499915.1_ASM2449991v1_genomic.gbff.gz,"Klebsiella michiganensis strain 6678897 1-6678897-GMCF-1144_(trimmed_pairs)_contig_1, whole genome shotgun sequence",1,,1,0,1
GCF_024542875.1_ASM2454287v1_genomic.gbff.gz,"Klebsiella michiganensis strain 17103428 Scaffold1, whole genome shotgun sequence",1,,1,0,1
GCF_024752295.1_ASM2475229v1_genomic.gbff.gz,"Klebsiella grimontii strain MIR 21 8838 NODE_100_length_388_cov_484.856, whole genome shotgun sequence",1,,1,0,1
GCF_024917295.1_ASM2491729v1_genomic.gbff.gz,"Klebsiella michiganensis strain 5088 chromosome, complete genome",8,,3,5,1
GCF_024918735.1_ASM2491873v1_genomic.gbff.gz,"Klebsiella oxytoca strain ST34 chromosome, complete genome",8,,6,2,2
GCF_025263805.1_ASM2526380v1_genomic.gbff.gz,"Klebsiella michiganensis strain BSI-KPN166 chromosome, complete genome",8,,8,0,4
GCF_025490535.1_ASM2549053v1_genomic.gbff.gz,"Klebsiella michiganensis strain 8BG chromosome, complete genome",8,,8,0,1
GCF_025579125.1_ASM2557912v2_genomic.gbff.gz,"Klebsiella oxytoca strain 2022CK-00499 chromosome, complete genome",8,,8,0,1
GCF_025665355.1_ASM2566535v1_genomic.gbff.gz,"Klebsiella michiganensis strain K5-3 chromosome, complete genome",8,,5,3,5
GCF_025676565.1_ASM2567656v2_genomic.gbff.gz,"Klebsiella oxytoca strain 2022CK-00498 chromosome, complete genome",8,,8,0,2
GCF_025732175.1_ASM2573217v1_genomic.gbff.gz,"Klebsiella oxytoca strain TYL-T1 chromosome, complete genome",8,,6,2,2
GCF_025770255.1_ASM2577025v1_genomic.gbff.gz,"Klebsiella oxytoca strain LZSYXJAT008 1, whole genome shotgun sequence",1,,1,0,1
GCF_025863555.1_ASM2586355v2_genomic.gbff.gz,"Klebsiella oxytoca strain 2022EL-00961 NODE_10_length_230217_cov_51.211065, whole genome shotgun sequence",0,All rRNA sequences shorter than 1400 bases,0,0
GCF_025863775.1_ASM2586377v2_genomic.gbff.gz,"Klebsiella oxytoca strain 2022EL-00956 NODE_100_length_967_cov_173.813095, whole genome shotgun sequence",0,All rRNA sequences shorter than 1400 bases,0,0
GCF_025950225.1_ASM2595022v1_genomic.gbff.gz,"Klebsiella oxytoca strain AAHC-1 NODE_10_length_230067_cov_68.4786_ID_1768, whole genome shotgun sequence",1,,1,0,1
GCF_025950405.1_ASM2595040v1_genomic.gbff.gz,"Klebsiella oxytoca strain AAHC-2 NODE_100_length_2017_cov_18.332634, whole genome shotgun sequence",0,All rRNA sequences shorter than 1400 bases,0,0
GCF_025960245.1_ASM2596024v1_genomic.gbff.gz,"Klebsiella michiganensis strain MX581 chromosome, complete genome",8,,8,0,1
GCF_026008455.1_ASM2600845v1_genomic.gbff.gz,"Klebsiella michiganensis strain NUBL-21980 sequence01, whole genome shotgun sequence",1,,1,0,1
GCF_026008475.1_ASM2600847v1_genomic.gbff.gz,"Klebsiella michiganensis strain NUBL-17187 sequence001, whole genome shotgun sequence",1,,1,0,1
GCF_026155385.1_ASM2615538v1_genomic.gbff.gz,"Klebsiella grimontii strain 46493 46493-00001, whole genome shotgun sequence",1,,1,0,1
GCF_026162305.1_ASM2616230v1_genomic.gbff.gz,"Klebsiella michiganensis strain MX578 NODE_10_length_185660_cov_167.195487, whole genome shotgun sequence",1,,1,0,1
GCF_026162385.1_ASM2616238v1_genomic.gbff.gz,"Klebsiella michiganensis strain MX518 NODE_10_length_204595_cov_126.791647, whole genome shotgun sequence",1,,1,0,1
GCF_026213795.1_ASM2621379v1_genomic.gbff.gz,"Klebsiella grimontii strain LF-2019B utg000001c:1.0-5838614.0_pilon, whole genome shotgun sequence",8,No sequences for consensus alignment,0,8,0
GCF_026223635.1_ASM2622363v1_genomic.gbff.gz,"Klebsiella michiganensis strain 1060_21 1060-21_S17_L001_R1_001__contig_1, whole genome shotgun sequence",1,,1,0,1
GCF_026223635.2_ASM2622363v2_genomic.gbff.gz,"Klebsiella michiganensis strain 1060_21 map unlocalized plasmid pID_1060_21 6, whole genome shotgun sequence",8,,3,5,2
GCF_026223815.1_ASM2622381v1_genomic.gbff.gz,"Klebsiella oxytoca strain 14/F0005 1, whole genome shotgun sequence",1,,1,0,1
GCF_026223825.1_ASM2622382v1_genomic.gbff.gz,"Klebsiella oxytoca strain 17KM1096 1, whole genome shotgun sequence",1,,1,0,1
GCF_026223895.1_ASM2622389v1_genomic.gbff.gz,"Klebsiella oxytoca strain 09KM0284 1, whole genome shotgun sequence",1,,1,0,1
GCF_026223915.1_ASM2622391v1_genomic.gbff.gz,"Klebsiella grimontii strain 20M0142 1, whole genome shotgun sequence",1,,1,0,1
GCF_026223935.1_ASM2622393v1_genomic.gbff.gz,"Klebsiella grimontii strain 08KM1900 1, whole genome shotgun sequence",1,,1,0,1
GCF_026223955.1_ASM2622395v1_genomic.gbff.gz,"Klebsiella michiganensis strain 15090013 1, whole genome shotgun sequence",0,All rRNA sequences shorter than 1400 bases,0,0
GCF_026223965.1_ASM2622396v1_genomic.gbff.gz,"Klebsiella michiganensis strain 15A0136 1, whole genome shotgun sequence",1,,1,0,1
GCF_026223975.1_ASM2622397v1_genomic.gbff.gz,"Klebsiella pasteurii strain 15Km1352 1, whole genome shotgun sequence",1,,1,0,1
GCF_026224015.1_ASM2622401v1_genomic.gbff.gz,"Klebsiella michiganensis strain ZH142-C 1, whole genome shotgun sequence",1,,1,0,1
GCF_026224035.1_ASM2622403v1_genomic.gbff.gz,"Klebsiella michiganensis strain 17KM0578 1, whole genome shotgun sequence",1,,1,0,1
GCF_026224055.1_ASM2622405v1_genomic.gbff.gz,"Klebsiella michiganensis strain 8310.44 1, whole genome shotgun sequence",0,All rRNA sequences shorter than 1400 bases,0,0
GCF_026224075.1_ASM2622407v1_genomic.gbff.gz,"Klebsiella oxytoca strain 08KM1888 1, whole genome shotgun sequence",1,,1,0,1
GCF_026224085.1_ASM2622408v1_genomic.gbff.gz,"Klebsiella michiganensis strain 7507.77 1, whole genome shotgun sequence",0,All rRNA sequences shorter than 1400 bases,0,0
GCF_026224115.1_ASM2622411v1_genomic.gbff.gz,"Klebsiella oxytoca strain 7907.16 1, whole genome shotgun sequence",0,All rRNA sequences shorter than 1400 bases,0,0
GCF_026224135.1_ASM2622413v1_genomic.gbff.gz,"Klebsiella oxytoca strain 7802.78 1, whole genome shotgun sequence",1,,1,0,1
GCF_026224155.1_ASM2622415v1_genomic.gbff.gz,"Klebsiella oxytoca strain 7510.48 1, whole genome shotgun sequence",1,,1,0,1
GCF_026224165.1_ASM2622416v1_genomic.gbff.gz,"Klebsiella oxytoca strain 7707.06 1, whole genome shotgun sequence",0,All rRNA sequences shorter than 1400 bases,0,0
GCF_026224195.1_ASM2622419v1_genomic.gbff.gz,"Klebsiella oxytoca strain 7610.07 1, whole genome shotgun sequence",1,,1,0,1
GCF_026224215.1_ASM2622421v1_genomic.gbff.gz,"Klebsiella oxytoca strain 8005.38-2 1, whole genome shotgun sequence",1,,1,0,1
GCF_026224235.1_ASM2622423v1_genomic.gbff.gz,"Klebsiella oxytoca strain 8005.38-1 1, whole genome shotgun sequence",1,,1,0,1
GCF_026224245.1_ASM2622424v1_genomic.gbff.gz,"Klebsiella oxytoca strain 8108.57 1, whole genome shotgun sequence",1,,1,0,1
GCF_026224275.1_ASM2622427v1_genomic.gbff.gz,"Klebsiella oxytoca strain 8306.21 1, whole genome shotgun sequence",1,,1,0,1
GCF_026224285.1_ASM2622428v1_genomic.gbff.gz,"Klebsiella oxytoca strain 8111.31 1, whole genome shotgun sequence",1,,1,0,1
GCF_026224315.1_ASM2622431v1_genomic.gbff.gz,"Klebsiella oxytoca strain 8310.33 1, whole genome shotgun sequence",0,All rRNA sequences shorter than 1400 bases,0,0
GCF_026224335.1_ASM2622433v1_genomic.gbff.gz,"Klebsiella oxytoca strain 8309.06 1, whole genome shotgun sequence",1,,1,0,1
GCF_026224355.1_ASM2622435v1_genomic.gbff.gz,"Klebsiella oxytoca strain 8310.32 1, whole genome shotgun sequence",0,All rRNA sequences shorter than 1400 bases,0,0
GCF_026224375.1_ASM2622437v1_genomic.gbff.gz,"Klebsiella oxytoca strain 8311.01 1, whole genome shotgun sequence",0,All rRNA sequences shorter than 1400 bases,0,0
GCF_026224385.1_ASM2622438v1_genomic.gbff.gz,"Klebsiella michiganensis strain 7806.19 1, whole genome shotgun sequence",0,All rRNA sequences shorter than 1400 bases,0,0
GCF_026224395.1_ASM2622439v1_genomic.gbff.gz,"Klebsiella michiganensis strain 7202.3 1, whole genome shotgun sequence",1,,1,0,1
GCF_026224435.1_ASM2622443v1_genomic.gbff.gz,"Klebsiella michiganensis strain 8011.16 1, whole genome shotgun sequence",1,,1,0,1
GCF_026224455.1_ASM2622445v1_genomic.gbff.gz,"Klebsiella michiganensis strain 8208.45 1, whole genome shotgun sequence",0,All rRNA sequences shorter than 1400 bases,0,0
GCF_026224475.1_ASM2622447v1_genomic.gbff.gz,"Klebsiella oxytoca strain KM57/09 1, whole genome shotgun sequence",1,,1,0,1
GCF_026224495.1_ASM2622449v1_genomic.gbff.gz,"Klebsiella oxytoca strain 13KM1040 1, whole genome shotgun sequence",1,,1,0,1
GCF_026224505.1_ASM2622450v1_genomic.gbff.gz,"Klebsiella oxytoca strain KM24/09 1, whole genome shotgun sequence",1,,1,0,1
GCF_026224535.1_ASM2622453v1_genomic.gbff.gz,"Klebsiella oxytoca strain 13KM0084 1, whole genome shotgun sequence",1,,1,0,1
GCF_026224545.1_ASM2622454v1_genomic.gbff.gz,"Klebsiella oxytoca strain 15KM0222 1, whole genome shotgun sequence",1,,1,0,1
GCF_026224595.1_ASM2622459v1_genomic.gbff.gz,"Klebsiella oxytoca strain 8212.48 1, whole genome shotgun sequence",1,,1,0,1
GCF_026224605.1_ASM2622460v1_genomic.gbff.gz,"Klebsiella michiganensis strain 1312240753 1, whole genome shotgun sequence",1,,1,0,1
GCF_026224645.1_ASM2622464v1_genomic.gbff.gz,"Klebsiella oxytoca strain 7407.04 1, whole genome shotgun sequence",1,,1,0,1
GCF_026224675.1_ASM2622467v1_genomic.gbff.gz,"Klebsiella michiganensis strain 5401.38 1, whole genome shotgun sequence",1,,1,0,1
GCF_026224695.1_ASM2622469v1_genomic.gbff.gz,"Klebsiella michiganensis strain 7907.29 1, whole genome shotgun sequence",1,,1,0,1
GCF_026274395.1_ASM2627439v1_genomic.gbff.gz,"Klebsiella michiganensis strain 2022EL-00969 NODE_10_length_190288_cov_54.378579, whole genome shotgun sequence",0,All rRNA sequences shorter than 1400 bases,0,0
GCF_026619535.1_ASM2661953v1_genomic.gbff.gz,"Klebsiella michiganensis strain X_33 1, whole genome shotgun sequence",8,,7,1,2
GCF_026627605.1_ASM2662760v1_genomic.gbff.gz,"Klebsiella michiganensis strain 2022EL-00762 NODE_10_length_223190_cov_33.342222, whole genome shotgun sequence",0,All rRNA sequences shorter than 1400 bases,0,0
GCF_026627765.1_ASM2662776v1_genomic.gbff.gz,"Klebsiella michiganensis strain 2022EL-00754 NODE_10_length_267503_cov_21.367295, whole genome shotgun sequence",0,All rRNA sequences shorter than 1400 bases,0,0
GCF_026702885.1_ASM2670288v1_genomic.gbff.gz,"Klebsiella oxytoca strain S42_CRE27b map unlocalized plasmid pCRE27b_1 contig3, whole genome shotgun sequence",8,,8,0,1
GCF_026703225.1_ASM2670322v1_genomic.gbff.gz,"Klebsiella michiganensis strain S17_CRE17 plasmid pCRE17_1, whole genome shotgun sequence",7,,7,0,1
GCF_026735415.1_ASM2673541v1_genomic.gbff.gz,"Klebsiella huaxiensis strain ZR-9 NODE_100_length_3462_cov_79.637814, whole genome shotgun sequence",0,All rRNA sequences shorter than 1400 bases,0,0
GCF_026735415.2_ASM2673541v2_genomic.gbff.gz,"Klebsiella huaxiensis strain ZR-9 plasmid pZRKH-FIA, whole genome shotgun sequence",8,,7,1,2
GCF_026967695.1_ASM2696769v1_genomic.gbff.gz,"Klebsiella michiganensis strain 2022CK-00497 chromosome, complete genome",8,,8,0,2
GCF_027257085.1_ASM2725708v1_genomic.gbff.gz,"Klebsiella oxytoca strain HA8pKo NODE, whole genome shotgun sequence",0,All rRNA sequences shorter than 1400 bases,0,0
GCF_027257135.1_ASM2725713v1_genomic.gbff.gz,"Klebsiella oxytoca strain HA10pKo NODE, whole genome shotgun sequence",0,All rRNA sequences shorter than 1400 bases,0,0
GCF_027257255.1_ASM2725725v1_genomic.gbff.gz,"Klebsiella oxytoca strain HA14pKo NODE, whole genome shotgun sequence",0,All rRNA sequences shorter than 1400 bases,0,0
GCF_027577885.1_ASM2757788v1_genomic.gbff.gz,"Klebsiella michiganensis strain 2022CK-00496 chromosome, complete genome",8,,8,0,2
GCF_027584345.1_ASM2758434v1_genomic.gbff.gz,"Klebsiella michiganensis strain NR2144 NR2144_1, whole genome shotgun sequence",8,,8,0,1
GCF_027584475.1_ASM2758447v1_genomic.gbff.gz,"Klebsiella michiganensis strain NR1295 NR1295_1, whole genome shotgun sequence",8,,6,2,1
GCF_027595545.1_ASM2759554v1_genomic.gbff.gz,"Klebsiella michiganensis strain S4_CRE4 chromosome, complete genome",8,,8,0,1
GCF_027627785.1_ASM2762778v1_genomic.gbff.gz,"Klebsiella oxytoca strain AHC-6 chromosome, complete genome",8,,4,4,2
GCF_027673125.1_ASM2767312v1_genomic.gbff.gz,"Klebsiella michiganensis strain AM113-44 IF3HH22001B.Scaf1, whole genome shotgun sequence",0,All rRNA sequences shorter than 1400 bases,0,0
GCF_027945215.1_ASM2794521v1_genomic.gbff.gz,"Klebsiella michiganensis strain 2563 chromosome, complete genome",8,,7,1,2
GCF_028368715.1_ASM2836871v1_genomic.gbff.gz,"Klebsiella pasteurii strain 2022EL-01099 NODE_10_length_218795_cov_32.941299, whole genome shotgun sequence",0,All rRNA sequences shorter than 1400 bases,0,0
GCF_028368775.1_ASM2836877v1_genomic.gbff.gz,"Klebsiella pasteurii strain 2022EL-01098 NODE_10_length_216808_cov_48.028332, whole genome shotgun sequence",0,All rRNA sequences shorter than 1400 bases,0,0
GCF_028622675.1_ASM2862267v1_genomic.gbff.gz,"Klebsiella grimontii strain 2022CK-00781 chromosome, complete genome",8,,7,1,2
GCF_028736015.1_ASM2873601v1_genomic.gbff.gz,"Klebsiella michiganensis strain 2020CK-00215 chromosome, complete genome",8,,8,0,2
GCF_028737615.1_ASM2873761v1_genomic.gbff.gz,"Klebsiella michiganensis strain 2022EL-00792 NODE_10_length_220160_cov_32.746206, whole genome shotgun sequence",0,All rRNA sequences shorter than 1400 bases,0,0
GCF_028737625.1_ASM2873762v1_genomic.gbff.gz,"Klebsiella michiganensis strain 2022EL-00823 NODE_10_length_205825_cov_18.690007, whole genome shotgun sequence",0,All rRNA sequences shorter than 1400 bases,0,0
GCF_028748965.1_ASM2874896v1_genomic.gbff.gz,"Klebsiella grimontii strain 2020CK-00211 chromosome, complete genome",8,,6,2,2
GCF_028768445.1_ASM2876844v1_genomic.gbff.gz,"Klebsiella grimontii strain YWC001 chromosome, complete genome",8,,8,0,1
GCF_028801985.1_ASM2880198v1_genomic.gbff.gz,"Klebsiella michiganensis strain FR 3 assembly_contig_1, whole genome shotgun sequence",1,,1,0,1
GCF_028802335.1_ASM2880233v1_genomic.gbff.gz,"Klebsiella pasteurii strain FR 108 assembly_contig_1, whole genome shotgun sequence",0,All rRNA sequences shorter than 1400 bases,0,0
GCF_028802425.1_ASM2880242v1_genomic.gbff.gz,"Klebsiella grimontii strain FR 111 assembly_contig_1, whole genome shotgun sequence",1,,1,0,1
GCF_028802575.1_ASM2880257v1_genomic.gbff.gz,"Klebsiella grimontii strain FR 100 assembly_contig_1, whole genome shotgun sequence",1,,1,0,1
GCF_028802585.1_ASM2880258v1_genomic.gbff.gz,"Klebsiella pasteurii strain FR 52 assembly_contig_1, whole genome shotgun sequence",1,,1,0,1
GCF_028802595.1_ASM2880259v1_genomic.gbff.gz,"Klebsiella pasteurii strain FR 50 assembly_contig_1, whole genome shotgun sequence",1,,1,0,1
GCF_028802675.1_ASM2880267v1_genomic.gbff.gz,"Klebsiella grimontii strain FR 21 assembly_contig_1, whole genome shotgun sequence",1,,1,0,1
GCF_028802695.1_ASM2880269v1_genomic.gbff.gz,"Klebsiella pasteurii strain FR 49 assembly_contig_1, whole genome shotgun sequence",1,,1,0,1
GCF_028802775.1_ASM2880277v1_genomic.gbff.gz,"Klebsiella grimontii strain FR 67 assembly_contig_1, whole genome shotgun sequence",1,,1,0,1
GCF_028807175.1_ASM2880717v1_genomic.gbff.gz,"Klebsiella grimontii strain FR 40 assembly_contig_1, whole genome shotgun sequence",1,,1,0,1
GCF_029002075.1_ASM2900207v1_genomic.gbff.gz,"Klebsiella michiganensis strain FR 19 assembly_contig_1, whole genome shotgun sequence",1,,1,0,1
GCF_029002115.1_ASM2900211v1_genomic.gbff.gz,"Klebsiella michiganensis strain FR 89 assembly_contig_1, whole genome shotgun sequence",1,,1,0,1
GCF_029002135.1_ASM2900213v1_genomic.gbff.gz,"Klebsiella michiganensis strain FR 129 assembly_contig_1, whole genome shotgun sequence",1,,1,0,1
GCF_029002155.1_ASM2900215v1_genomic.gbff.gz,"Klebsiella michiganensis strain FR 1 assembly_contig_1, whole genome shotgun sequence",1,,1,0,1
GCF_029027885.1_ASM2902788v1_genomic.gbff.gz,"Klebsiella michiganensis strain YZUMF202001 chromosome, complete genome",8,,8,0,1
GCF_029202365.1_ASM2920236v1_genomic.gbff.gz,"MAG: Klebsiella huaxiensis isolate MAG 1521 chromosome, complete genome",8,,6,2,2
GCF_029226505.1_ASM2922650v1_genomic.gbff.gz,"Klebsiella oxytoca strain 2020CK-00213 chromosome, complete genome",8,,8,0,2
GCF_029718665.1_ASM2971866v1_genomic.gbff.gz,"Klebsiella michiganensis strain RHB20-SO-C02 chromosome, complete genome",8,,8,0,1
GCF_029718685.1_ASM2971868v1_genomic.gbff.gz,"Klebsiella michiganensis strain RHB20-SO-C01 chromosome, complete genome",8,,8,0,1
GCF_029836315.1_ASM2983631v1_genomic.gbff.gz,"Klebsiella pasteurii strain GD04085 1, whole genome shotgun sequence",1,,1,0,1
GCF_029836415.1_ASM2983641v1_genomic.gbff.gz,"Klebsiella michiganensis strain GD04079 1, whole genome shotgun sequence",1,,1,0,1
GCF_029836625.1_ASM2983662v1_genomic.gbff.gz,"Klebsiella grimontii strain GD04070 1, whole genome shotgun sequence",1,,1,0,1
GCF_029836835.1_ASM2983683v1_genomic.gbff.gz,"Klebsiella grimontii strain GD04057 1, whole genome shotgun sequence",1,,1,0,1
GCF_029837225.1_ASM2983722v1_genomic.gbff.gz,"Klebsiella grimontii strain GD04038 1, whole genome shotgun sequence",1,,1,0,1
GCF_029837375.1_ASM2983737v1_genomic.gbff.gz,"Klebsiella michiganensis strain GD04031 1, whole genome shotgun sequence",1,,1,0,1
GCF_029837515.1_ASM2983751v1_genomic.gbff.gz,"Klebsiella oxytoca strain GD04023 1, whole genome shotgun sequence",1,,1,0,1
GCF_029838015.1_ASM2983801v1_genomic.gbff.gz,"Klebsiella michiganensis strain GD03999 1, whole genome shotgun sequence",0,All rRNA sequences shorter than 1400 bases,0,0
GCF_029839645.1_ASM2983964v1_genomic.gbff.gz,"Klebsiella michiganensis strain GD03924 1, whole genome shotgun sequence",1,,1,0,1
GCF_029840005.1_ASM2984000v1_genomic.gbff.gz,"Klebsiella michiganensis strain GD03905 1, whole genome shotgun sequence",0,All rRNA sequences shorter than 1400 bases,0,0
GCF_029840205.1_ASM2984020v1_genomic.gbff.gz,"Klebsiella grimontii strain GD03894 1, whole genome shotgun sequence",1,,1,0,1
GCF_029840365.1_ASM2984036v1_genomic.gbff.gz,"Klebsiella michiganensis strain GD03887 1, whole genome shotgun sequence",1,,1,0,1
GCF_029840445.1_ASM2984044v1_genomic.gbff.gz,"Klebsiella michiganensis strain GD03883 1, whole genome shotgun sequence",1,,1,0,1
GCF_029841425.1_ASM2984142v1_genomic.gbff.gz,"Klebsiella michiganensis strain GD03831 1, whole genome shotgun sequence",1,,1,0,1
GCF_029841545.1_ASM2984154v1_genomic.gbff.gz,"Klebsiella michiganensis strain GD03824 CBOKHBLH_1, whole genome shotgun sequence",7,,3,4,1
GCF_029841985.1_ASM2984198v1_genomic.gbff.gz,"Klebsiella michiganensis strain GD03802 1, whole genome shotgun sequence",1,,1,0,1
GCF_029842245.1_ASM2984224v1_genomic.gbff.gz,"Klebsiella michiganensis strain GD03789 EDAFPGOG_1, whole genome shotgun sequence",8,,8,0,1
GCF_029842355.1_ASM2984235v1_genomic.gbff.gz,"Klebsiella michiganensis strain GD03783 1, whole genome shotgun sequence",0,All rRNA sequences shorter than 1400 bases,0,0
GCF_029844325.1_ASM2984432v1_genomic.gbff.gz,"Klebsiella michiganensis strain GD03693 1, whole genome shotgun sequence",1,,1,0,1
GCF_029844645.1_ASM2984464v1_genomic.gbff.gz,"Klebsiella grimontii strain GD03677 1, whole genome shotgun sequence",1,,1,0,1
GCF_029960265.1_ASM2996026v1_genomic.gbff.gz,"Klebsiella michiganensis strain HGDC6_1 contig00001, whole genome shotgun sequence",1,,1,0,1
GCF_029960425.1_ASM2996042v1_genomic.gbff.gz,"Klebsiella michiganensis strain HEE22_1 contig00001, whole genome shotgun sequence",0,All rRNA sequences shorter than 1400 bases,0,0
GCF_030164605.1_ASM3016460v1_genomic.gbff.gz,"Klebsiella michiganensis strain B1-2b NODE_100_length_351_cov_135.116788, whole genome shotgun sequence",0,All rRNA sequences shorter than 1400 bases,0,0
GCF_030164645.1_ASM3016464v1_genomic.gbff.gz,"Klebsiella michiganensis strain B1-2a NODE_100_length_1203_cov_267.794849, whole genome shotgun sequence",0,All rRNA sequences shorter than 1400 bases,0,0
GCF_030169945.1_ASM3016994v1_genomic.gbff.gz,"Klebsiella pasteurii strain AHM8C130-1I chromosome, complete genome",8,,8,0,1
GCF_030183005.1_ASM3018300v1_genomic.gbff.gz,"Klebsiella oxytoca strain CPO534 contig00001, whole genome shotgun sequence",0,All rRNA sequences shorter than 1400 bases,0,0
GCF_030183005.2_NA_genomic.gbff.gz,"Klebsiella oxytoca strain CPO534 1, whole genome shotgun sequence",8,,8,0,1
GCF_030185035.1_ASM3018503v1_genomic.gbff.gz,"Klebsiella michiganensis strain CPO262 contig00001, whole genome shotgun sequence",0,All rRNA sequences shorter than 1400 bases,0,0
GCF_030185035.2_NA_genomic.gbff.gz,"Klebsiella michiganensis strain CPO262 1, whole genome shotgun sequence",8,,8,0,1
GCF_030185235.1_NA_genomic.gbff.gz,"Klebsiella michiganensis strain CPO249 1, whole genome shotgun sequence",8,,8,0,1
GCF_030185295.1_NA_genomic.gbff.gz,"Klebsiella michiganensis strain CPO243 1, whole genome shotgun sequence",8,,8,0,1
GCF_030186415.1_ASM3018641v1_genomic.gbff.gz,"Klebsiella oxytoca strain CPO120 contig00001, whole genome shotgun sequence",0,All rRNA sequences shorter than 1400 bases,0,0
GCF_030193755.1_ASM3019375v1_genomic.gbff.gz,"Klebsiella pasteurii strain AHM8C132-2I NODE_10_length_195424_cov_74.674588, whole genome shotgun sequence",0,All rRNA sequences shorter than 1400 bases,0,0
GCF_030193795.1_ASM3019379v1_genomic.gbff.gz,"Klebsiella pasteurii strain AHM8C130-1I NODE_10_length_216794_cov_84.050844, whole genome shotgun sequence",0,All rRNA sequences shorter than 1400 bases,0,0
GCF_030194355.1_ASM3019435v1_genomic.gbff.gz,"Klebsiella oxytoca strain AHM21C2953KI NODE_100_length_252_cov_49.433962, whole genome shotgun sequence",0,All rRNA sequences shorter than 1400 bases,0,0
GCF_030194365.1_ASM3019436v1_genomic.gbff.gz,"Klebsiella oxytoca strain AHM21C2954KI NODE_100_length_252_cov_46.704403, whole genome shotgun sequence",0,All rRNA sequences shorter than 1400 bases,0,0
GCF_030194535.1_ASM3019453v1_genomic.gbff.gz,"Klebsiella oxytoca strain AHM21C2952BI NODE_100_length_258_cov_84.787879, whole genome shotgun sequence",0,All rRNA sequences shorter than 1400 bases,0,0
GCF_030195115.1_ASM3019511v1_genomic.gbff.gz,"Klebsiella oxytoca strain AHM21C2892KI NODE_10_length_207832_cov_78.779685, whole genome shotgun sequence",0,All rRNA sequences shorter than 1400 bases,0,0
GCF_030195175.1_ASM3019517v1_genomic.gbff.gz,"Klebsiella oxytoca strain AHM21C2893KI NODE_100_length_270_cov_63.124294, whole genome shotgun sequence",0,All rRNA sequences shorter than 1400 bases,0,0
GCF_030195225.1_ASM3019522v1_genomic.gbff.gz,"Klebsiella oxytoca strain AHM21C2889KI NODE_100_length_258_cov_97.472727, whole genome shotgun sequence",0,All rRNA sequences shorter than 1400 bases,0,0
GCF_030195575.1_ASM3019557v1_genomic.gbff.gz,"Klebsiella oxytoca strain AHM21C2862KI NODE_10_length_211462_cov_80.339085, whole genome shotgun sequence",0,All rRNA sequences shorter than 1400 bases,0,0
GCF_030213545.1_ASM3021354v1_genomic.gbff.gz,"Klebsiella oxytoca strain UMB9210A NODE_100_length_510_cov_0.789838, whole genome shotgun sequence",0,All rRNA sequences shorter than 1400 bases,0,0
GCF_030215845.1_ASM3021584v1_genomic.gbff.gz,"Klebsiella michiganensis strain UMB8372 NODE_100_length_1287_cov_49.202479, whole genome shotgun sequence",0,All rRNA sequences shorter than 1400 bases,0,0
GCF_030216235.1_ASM3021623v1_genomic.gbff.gz,"Klebsiella grimontii strain UMB8064 NODE_100_length_629_cov_0.815217, whole genome shotgun sequence",0,All rRNA sequences shorter than 1400 bases,0,0
GCF_030225535.1_ASM3022553v1_genomic.gbff.gz,"Klebsiella oxytoca strain UMB10483 NODE_100_length_295_cov_0.605505, whole genome shotgun sequence",0,All rRNA sequences shorter than 1400 bases,0,0
GCF_030225565.1_ASM3022556v1_genomic.gbff.gz,"Klebsiella michiganensis strain UMB9553 NODE_100_length_2272_cov_31.025968, whole genome shotgun sequence",0,All rRNA sequences shorter than 1400 bases,0,0
GCF_030225605.1_ASM3022560v1_genomic.gbff.gz,"Klebsiella oxytoca strain UMB9210B NODE_100_length_313_cov_13.457627, whole genome shotgun sequence",0,All rRNA sequences shorter than 1400 bases,0,0
GCF_030225715.1_ASM3022571v1_genomic.gbff.gz,"Klebsiella oxytoca strain UMB10500 NODE_100_length_290_cov_64.464789, whole genome shotgun sequence",0,All rRNA sequences shorter than 1400 bases,0,0
GCF_030248395.1_ASM3024839v1_genomic.gbff.gz,"Klebsiella michiganensis strain ETN19 1, whole genome shotgun sequence",8,,8,0,1
GCF_030283225.1_ASM3028322v1_genomic.gbff.gz,"Klebsiella michiganensis strain CPO453 contig_1, whole genome shotgun sequence",8,,6,2,2
GCF_030283425.1_ASM3028342v1_genomic.gbff.gz,"Klebsiella michiganensis strain CPO404 contig_1, whole genome shotgun sequence",8,,4,4,2
GCF_030283905.1_ASM3028390v1_genomic.gbff.gz,"Klebsiella michiganensis strain CPO282 contig_1, whole genome shotgun sequence",8,,6,2,2
GCF_030286175.1_ASM3028617v1_genomic.gbff.gz,"Klebsiella michiganensis strain UTM00027 chromosome, whole genome shotgun sequence",8,,8,0,1
GCF_030291695.1_ASM3029169v1_genomic.gbff.gz,"Klebsiella michiganensis strain ELP1.34B chromosome, complete genome",8,,8,0,1
GCF_030294205.1_ASM3029420v1_genomic.gbff.gz,"Klebsiella michiganensis strain CPO595 CPO595_contig_1, whole genome shotgun sequence",8,,6,2,2
GCF_030294285.1_ASM3029428v1_genomic.gbff.gz,"Klebsiella michiganensis strain CPO266 1, whole genome shotgun sequence",8,,8,0,2
GCF_030294485.1_ASM3029448v1_genomic.gbff.gz,"Klebsiella michiganensis strain CPO433 1, whole genome shotgun sequence",8,,4,4,2
GCF_030342765.1_ASM3034276v1_genomic.gbff.gz,"Klebsiella oxytoca strain NMI7406_19 NODE_100_length_473_cov_104.447977, whole genome shotgun sequence",0,All rRNA sequences shorter than 1400 bases,0,0
GCF_030342775.1_ASM3034277v1_genomic.gbff.gz,"Klebsiella oxytoca strain NMI6955_19 NODE_100_length_1389_cov_144.931062, whole genome shotgun sequence",0,All rRNA sequences shorter than 1400 bases,0,0
GCF_030342805.1_ASM3034280v1_genomic.gbff.gz,"Klebsiella oxytoca strain NMI10340_19 NODE_103_length_416_cov_54.833910, whole genome shotgun sequence",0,All rRNA sequences shorter than 1400 bases,0,0
GCF_030342845.1_ASM3034284v1_genomic.gbff.gz,"Klebsiella michiganensis strain NMI10279_19 NODE_100_length_385_cov_8.686047, whole genome shotgun sequence",1,,1,0,1
GCF_030342865.1_ASM3034286v1_genomic.gbff.gz,"Klebsiella oxytoca strain NMI7512_19 NODE_100_length_1415_cov_16.305124, whole genome shotgun sequence",0,All rRNA sequences shorter than 1400 bases,0,0
GCF_030342875.1_ASM3034287v1_genomic.gbff.gz,"Klebsiella oxytoca strain NMI10246_19 NODE_100_length_913_cov_69.092875, whole genome shotgun sequence",0,All rRNA sequences shorter than 1400 bases,0,0
GCF_030342905.1_ASM3034290v1_genomic.gbff.gz,"Klebsiella oxytoca strain NMI10316_19 NODE_100_length_383_cov_39.238281, whole genome shotgun sequence",0,All rRNA sequences shorter than 1400 bases,0,0
GCF_030342925.1_ASM3034292v1_genomic.gbff.gz,"Klebsiella michiganensis strain NMI9543_19 NODE_100_length_1338_cov_227.218827, whole genome shotgun sequence",0,All rRNA sequences shorter than 1400 bases,0,0
GCF_030342935.1_ASM3034293v1_genomic.gbff.gz,"Klebsiella michiganensis strain NMI8545_19 NODE_100_length_1233_cov_39.122061, whole genome shotgun sequence",0,All rRNA sequences shorter than 1400 bases,0,0
GCF_030342985.1_ASM3034298v1_genomic.gbff.gz,"Klebsiella oxytoca strain NMI8015_19 NODE_100_length_1085_cov_64.930063, whole genome shotgun sequence",0,All rRNA sequences shorter than 1400 bases,0,0
GCF_030342995.1_ASM3034299v1_genomic.gbff.gz,"Klebsiella oxytoca strain NMI6337_19 NODE_100_length_1859_cov_35.504619, whole genome shotgun sequence",0,All rRNA sequences shorter than 1400 bases,0,0
GCF_030343045.1_ASM3034304v1_genomic.gbff.gz,"Klebsiella oxytoca strain NMI253_19 NODE_103_length_467_cov_88.885294, whole genome shotgun sequence",0,All rRNA sequences shorter than 1400 bases,0,0
GCF_030343045.2_ASM3034304v2_genomic.gbff.gz,"Klebsiella oxytoca strain NMI253_19 1, whole genome shotgun sequence",8,,8,0,1
GCF_030343055.1_ASM3034305v1_genomic.gbff.gz,"Klebsiella oxytoca strain NMI768_19 NODE_105_length_445_cov_57.371069, whole genome shotgun sequence",0,All rRNA sequences shorter than 1400 bases,0,0
GCF_030343095.1_ASM3034309v1_genomic.gbff.gz,"Klebsiella oxytoca strain NMI221_19 NODE_100_length_1499_cov_294.878280, whole genome shotgun sequence",0,All rRNA sequences shorter than 1400 bases,0,0
GCF_030343105.1_ASM3034310v1_genomic.gbff.gz,"Klebsiella oxytoca strain NMI1636_19 NODE_100_length_1412_cov_181.557977, whole genome shotgun sequence",0,All rRNA sequences shorter than 1400 bases,0,0
GCF_030343165.1_ASM3034316v1_genomic.gbff.gz,"Klebsiella oxytoca strain NMI7904_18 NODE_100_length_1336_cov_143.634409, whole genome shotgun sequence",0,All rRNA sequences shorter than 1400 bases,0,0
GCF_030343185.1_ASM3034318v1_genomic.gbff.gz,"Klebsiella pasteurii strain NMI6490_18 NODE_101_length_623_cov_171.258065, whole genome shotgun sequence",0,All rRNA sequences shorter than 1400 bases,0,0
GCF_030343205.1_ASM3034320v1_genomic.gbff.gz,"Klebsiella spallanzanii strain NMI7090_18 NODE_10_length_226237_cov_57.890748, whole genome shotgun sequence",0,All rRNA sequences shorter than 1400 bases,0,0
GCF_030343225.1_ASM3034322v1_genomic.gbff.gz,"Klebsiella oxytoca strain NMI7702_18 NODE_100_length_1427_cov_31.366154, whole genome shotgun sequence",0,All rRNA sequences shorter than 1400 bases,0,0
GCF_030343235.1_ASM3034323v1_genomic.gbff.gz,"Klebsiella oxytoca strain NMI7009_18 NODE_100_length_763_cov_149.385220, whole genome shotgun sequence",0,All rRNA sequences shorter than 1400 bases,0,0
GCF_030343265.1_ASM3034326v1_genomic.gbff.gz,"Klebsiella oxytoca strain NMI6107_18 NODE_101_length_773_cov_47.746130, whole genome shotgun sequence",0,All rRNA sequences shorter than 1400 bases,0,0
GCF_030343285.1_ASM3034328v1_genomic.gbff.gz,"Klebsiella oxytoca strain NMI4759_17 NODE_100_length_1427_cov_28.606923, whole genome shotgun sequence",0,All rRNA sequences shorter than 1400 bases,0,0
GCF_030343295.1_ASM3034329v1_genomic.gbff.gz,"Klebsiella oxytoca strain NMI5439_18 NODE_100_length_1415_cov_37.317547, whole genome shotgun sequence",0,All rRNA sequences shorter than 1400 bases,0,0
GCF_030343325.1_ASM3034332v1_genomic.gbff.gz,"Klebsiella oxytoca strain NMI388_18 NODE_100_length_255_cov_80.640625, whole genome shotgun sequence",0,All rRNA sequences shorter than 1400 bases,0,0
GCF_030343345.1_ASM3034334v1_genomic.gbff.gz,"Klebsiella oxytoca strain NMI2437_18 NODE_100_length_2977_cov_73.029123, whole genome shotgun sequence",0,All rRNA sequences shorter than 1400 bases,0,0
GCF_030343365.1_ASM3034336v1_genomic.gbff.gz,"Klebsiella oxytoca strain NMI905_17 NODE_100_length_1542_cov_41.758304, whole genome shotgun sequence",0,All rRNA sequences shorter than 1400 bases,0,0
GCF_030343375.1_ASM3034337v1_genomic.gbff.gz,"Klebsiella oxytoca strain NMI2383_18 NODE_100_length_1504_cov_35.440087, whole genome shotgun sequence",0,All rRNA sequences shorter than 1400 bases,0,0
GCF_030343405.1_ASM3034340v1_genomic.gbff.gz,"Klebsiella oxytoca strain NMI8275_17 NODE_100_length_248_cov_76.264463, whole genome shotgun sequence",0,All rRNA sequences shorter than 1400 bases,0,0
GCF_030343425.1_ASM3034342v1_genomic.gbff.gz,"Klebsiella oxytoca strain NMI5947_17 NODE_100_length_1542_cov_38.708127, whole genome shotgun sequence",0,All rRNA sequences shorter than 1400 bases,0,0
GCF_030343445.1_ASM3034344v1_genomic.gbff.gz,"Klebsiella oxytoca strain NMI6676_17 NODE_100_length_1443_cov_239.951368, whole genome shotgun sequence",0,All rRNA sequences shorter than 1400 bases,0,0
GCF_030343465.1_ASM3034346v1_genomic.gbff.gz,"Klebsiella oxytoca strain NMI6751_17 NODE_100_length_632_cov_82.615842, whole genome shotgun sequence",0,All rRNA sequences shorter than 1400 bases,0,0
GCF_030343485.1_ASM3034348v1_genomic.gbff.gz,"Klebsiella oxytoca strain NMI5438_18 NODE_100_length_646_cov_278.447013, whole genome shotgun sequence",0,All rRNA sequences shorter than 1400 bases,0,0
GCF_030343495.1_ASM3034349v1_genomic.gbff.gz,"Klebsiella oxytoca strain NMI460_17 NODE_100_length_659_cov_373.838346, whole genome shotgun sequence",0,All rRNA sequences shorter than 1400 bases,0,0
GCF_030343545.1_ASM3034354v1_genomic.gbff.gz,"Klebsiella oxytoca strain NMI5138_17 NODE_100_length_1324_cov_59.690058, whole genome shotgun sequence",0,All rRNA sequences shorter than 1400 bases,0,0
GCF_030343565.1_ASM3034356v1_genomic.gbff.gz,"Klebsiella oxytoca strain NMI4062_17 NODE_100_length_1682_cov_49.484887, whole genome shotgun sequence",0,All rRNA sequences shorter than 1400 bases,0,0
GCF_030343625.1_ASM3034362v1_genomic.gbff.gz,"Klebsiella oxytoca strain NMI2990_17 NODE_100_length_528_cov_379.897756, whole genome shotgun sequence",0,All rRNA sequences shorter than 1400 bases,0,0
GCF_030343625.2_ASM3034362v2_genomic.gbff.gz,"Klebsiella oxytoca strain NMI2990_17 chromosome, complete genome",8,,8,0,1
GCF_030343645.1_ASM3034364v1_genomic.gbff.gz,"Klebsiella oxytoca strain NMI196_17 NODE_100_length_1231_cov_106.056159, whole genome shotgun sequence",0,All rRNA sequences shorter than 1400 bases,0,0
GCF_030343655.1_ASM3034365v1_genomic.gbff.gz,"Klebsiella oxytoca strain NMI8748_18 NODE_100_length_1340_cov_114.620775, whole genome shotgun sequence",0,All rRNA sequences shorter than 1400 bases,0,0
GCF_030343685.1_ASM3034368v1_genomic.gbff.gz,"Klebsiella oxytoca strain NMI7212_16 NODE_100_length_1504_cov_37.701525, whole genome shotgun sequence",0,All rRNA sequences shorter than 1400 bases,0,0
GCF_030343705.1_ASM3034370v1_genomic.gbff.gz,"Klebsiella oxytoca strain NMI2226_19 NODE_100_length_1541_cov_32.910184, whole genome shotgun sequence",0,All rRNA sequences shorter than 1400 bases,0,0
GCF_030343745.1_ASM3034374v1_genomic.gbff.gz,"Klebsiella michiganensis strain NMI1086_17 NODE_10_length_228018_cov_40.218183, whole genome shotgun sequence",1,,1,0,1
GCF_030343755.1_ASM3034375v1_genomic.gbff.gz,"Klebsiella michiganensis strain NMI1085_17 NODE_104_length_479_cov_64.005682, whole genome shotgun sequence",1,,1,0,1
GCF_030343825.1_ASM3034382v1_genomic.gbff.gz,"Klebsiella oxytoca strain NMI6209_16 NODE_100_length_1204_cov_75.605385, whole genome shotgun sequence",0,All rRNA sequences shorter than 1400 bases,0,0
GCF_030343845.1_ASM3034384v1_genomic.gbff.gz,"Klebsiella oxytoca strain NMI5491_16 NODE_100_length_2674_cov_97.157440, whole genome shotgun sequence",0,All rRNA sequences shorter than 1400 bases,0,0
GCF_030343865.1_ASM3034386v1_genomic.gbff.gz,"Klebsiella oxytoca strain NMI5636_16 NODE_100_length_255_cov_304.789062, whole genome shotgun sequence",0,All rRNA sequences shorter than 1400 bases,0,0
GCF_030343875.1_ASM3034387v1_genomic.gbff.gz,"Klebsiella grimontii strain NMI5535_16 NODE_100_length_332_cov_88.907317, whole genome shotgun sequence",0,All rRNA sequences shorter than 1400 bases,0,0
GCF_030343905.1_ASM3034390v1_genomic.gbff.gz,"Klebsiella oxytoca strain NMI4025_16 NODE_100_length_1566_cov_111.412092, whole genome shotgun sequence",0,All rRNA sequences shorter than 1400 bases,0,0
GCF_030343925.1_ASM3034392v1_genomic.gbff.gz,"Klebsiella oxytoca strain NMI2260_16 NODE_100_length_1188_cov_29.458058, whole genome shotgun sequence",0,All rRNA sequences shorter than 1400 bases,0,0
GCF_030343945.1_ASM3034394v1_genomic.gbff.gz,"Klebsiella oxytoca strain NMI723_16 NODE_100_length_1560_cov_38.764829, whole genome shotgun sequence",0,All rRNA sequences shorter than 1400 bases,0,0
GCF_030344005.1_ASM3034400v1_genomic.gbff.gz,"Klebsiella oxytoca strain NMI347_16 NODE_100_length_1163_cov_88.424710, whole genome shotgun sequence",0,All rRNA sequences shorter than 1400 bases,0,0
GCF_030344035.1_ASM3034403v1_genomic.gbff.gz,"Klebsiella oxytoca strain NMI601_15 NODE_100_length_585_cov_42.674672, whole genome shotgun sequence",0,All rRNA sequences shorter than 1400 bases,0,0
GCF_030344065.1_ASM3034406v1_genomic.gbff.gz,"Klebsiella oxytoca strain NMI1879_15 NODE_100_length_1233_cov_121.647378, whole genome shotgun sequence",0,All rRNA sequences shorter than 1400 bases,0,0
GCF_030344075.1_ASM3034407v1_genomic.gbff.gz,"Klebsiella oxytoca strain NMI4566_15 NODE_100_length_1389_cov_124.145800, whole genome shotgun sequence",0,All rRNA sequences shorter than 1400 bases,0,0
GCF_030344175.1_ASM3034417v1_genomic.gbff.gz,"Klebsiella oxytoca strain NMI1362_14 NODE_100_length_644_cov_68.618956, whole genome shotgun sequence",0,All rRNA sequences shorter than 1400 bases,0,0
GCF_030344215.1_ASM3034421v1_genomic.gbff.gz,"Klebsiella oxytoca strain NMI626_14 NODE_100_length_951_cov_28.916262, whole genome shotgun sequence",0,All rRNA sequences shorter than 1400 bases,0,0
GCF_030344265.1_ASM3034426v1_genomic.gbff.gz,"Klebsiella oxytoca strain NMI4806_13 NODE_101_length_409_cov_95.503546, whole genome shotgun sequence",0,All rRNA sequences shorter than 1400 bases,0,0
GCF_030344305.1_ASM3034430v1_genomic.gbff.gz,"Klebsiella michiganensis strain NMI3664_13 NODE_104_length_431_cov_48.963816, whole genome shotgun sequence",0,All rRNA sequences shorter than 1400 bases,0,0
GCF_030344325.1_ASM3034432v1_genomic.gbff.gz,"Klebsiella oxytoca strain NMI2978_13 NODE_100_length_342_cov_34.451163, whole genome shotgun sequence",0,All rRNA sequences shorter than 1400 bases,0,0
GCF_030344345.1_ASM3034434v1_genomic.gbff.gz,"Klebsiella oxytoca strain NMI1536_13 NODE_100_length_254_cov_31.551181, whole genome shotgun sequence",0,All rRNA sequences shorter than 1400 bases,0,0
GCF_030344365.1_ASM3034436v1_genomic.gbff.gz,"Klebsiella michiganensis strain NMI1752_13 NODE_109_length_550_cov_178.888889, whole genome shotgun sequence",0,All rRNA sequences shorter than 1400 bases,0,0
GCF_030344405.1_ASM3034440v1_genomic.gbff.gz,"Klebsiella oxytoca strain NMI6679_12 NODE_100_length_1946_cov_131.418362, whole genome shotgun sequence",0,All rRNA sequences shorter than 1400 bases,0,0
GCF_030344465.1_ASM3034446v1_genomic.gbff.gz,"Klebsiella oxytoca strain NMI5820_12 NODE_100_length_270_cov_28.748252, whole genome shotgun sequence",1,,1,0,1
GCF_030344505.1_ASM3034450v1_genomic.gbff.gz,"Klebsiella oxytoca strain NMI3936_12 NODE_100_length_644_cov_91.226306, whole genome shotgun sequence",0,All rRNA sequences shorter than 1400 bases,0,0
GCF_030344515.1_ASM3034451v1_genomic.gbff.gz,"Klebsiella oxytoca strain NMI3934_12 NODE_100_length_683_cov_74.899281, whole genome shotgun sequence",0,All rRNA sequences shorter than 1400 bases,0,0
GCF_030344545.1_ASM3034454v1_genomic.gbff.gz,"Klebsiella oxytoca strain NMI9347_11 NODE_100_length_1018_cov_279.983165, whole genome shotgun sequence",0,All rRNA sequences shorter than 1400 bases,0,0
GCF_030344565.1_ASM3034456v1_genomic.gbff.gz,"Klebsiella oxytoca strain NMI5190_11 NODE_100_length_773_cov_38.229102, whole genome shotgun sequence",0,All rRNA sequences shorter than 1400 bases,0,0
GCF_030344645.1_ASM3034464v1_genomic.gbff.gz,"Klebsiella oxytoca strain NMI445_11 NODE_100_length_588_cov_22.726681, whole genome shotgun sequence",0,All rRNA sequences shorter than 1400 bases,0,0
GCF_030344665.1_ASM3034466v1_genomic.gbff.gz,"Klebsiella oxytoca strain NMI377_11 NODE_100_length_657_cov_78.258491, whole genome shotgun sequence",0,All rRNA sequences shorter than 1400 bases,0,0
GCF_030344695.1_ASM3034469v1_genomic.gbff.gz,"Klebsiella oxytoca strain NMI5944_10 NODE_100_length_585_cov_95.336245, whole genome shotgun sequence",0,All rRNA sequences shorter than 1400 bases,0,0
GCF_030344725.1_ASM3034472v1_genomic.gbff.gz,"Klebsiella oxytoca strain NMI4204_10 NODE_100_length_1256_cov_49.637733, whole genome shotgun sequence",0,All rRNA sequences shorter than 1400 bases,0,0
GCF_030344735.1_ASM3034473v1_genomic.gbff.gz,"Klebsiella oxytoca strain NMI3809_10 NODE_100_length_586_cov_280.710240, whole genome shotgun sequence",0,All rRNA sequences shorter than 1400 bases,0,0
GCF_030344765.1_ASM3034476v1_genomic.gbff.gz,"Klebsiella oxytoca strain NMI1674_10 NODE_100_length_818_cov_91.108538, whole genome shotgun sequence",0,All rRNA sequences shorter than 1400 bases,0,0
GCF_030344785.1_ASM3034478v1_genomic.gbff.gz,"Klebsiella oxytoca strain NMI_2833_09 NODE_100_length_646_cov_165.662813, whole genome shotgun sequence",0,All rRNA sequences shorter than 1400 bases,0,0
GCF_030344825.1_ASM3034482v1_genomic.gbff.gz,"Klebsiella oxytoca strain NMI2092_09 NODE_100_length_494_cov_53.653951, whole genome shotgun sequence",0,All rRNA sequences shorter than 1400 bases,0,0
GCF_030344825.2_ASM3034482v2_genomic.gbff.gz,"Klebsiella oxytoca strain NMI2092_09 1, whole genome shotgun sequence",8,,8,0,1
GCF_030358065.1_ASM3035806v1_genomic.gbff.gz,"Klebsiella michiganensis strain TUM14377 NODE_100_length_21601_cov_14.022818, whole genome shotgun sequence",1,,1,0,1
GCF_030358075.1_ASM3035807v1_genomic.gbff.gz,"Klebsiella grimontii strain TUM14374 NODE_100_length_1536_cov_5.363378, whole genome shotgun sequence",1,,1,0,1
GCF_030358825.1_ASM3035882v1_genomic.gbff.gz,"Klebsiella michiganensis strain TUM13847 NODE_1_length_158585_cov_13.4033, whole genome shotgun sequence",1,,1,0,1
GCF_030358865.1_ASM3035886v1_genomic.gbff.gz,"Klebsiella michiganensis strain TUM13848 NODE_1_length_217875_cov_19.5866, whole genome shotgun sequence",1,,1,0,1
GCF_030358885.1_ASM3035888v1_genomic.gbff.gz,"Klebsiella michiganensis strain TUM13845 NODE_1_length_195922_cov_15.188197, whole genome shotgun sequence",1,,1,0,1
GCF_030358925.1_ASM3035892v1_genomic.gbff.gz,"Klebsiella michiganensis strain TUM13843 NODE_1_length_118899_cov_14.952556, whole genome shotgun sequence",1,,1,0,1
GCF_030358945.1_ASM3035894v1_genomic.gbff.gz,"Klebsiella michiganensis strain TUM13844 NODE_1_length_196518_cov_14.406185, whole genome shotgun sequence",1,,1,0,1
GCF_030358965.1_ASM3035896v1_genomic.gbff.gz,"Klebsiella michiganensis strain TUM13842 NODE_1_length_295812_cov_18.8891, whole genome shotgun sequence",1,,1,0,1
GCF_030358985.1_ASM3035898v1_genomic.gbff.gz,"Klebsiella michiganensis strain TUM13841 NODE_1_length_266199_cov_22.657672, whole genome shotgun sequence",1,,1,0,1
GCF_030359005.1_ASM3035900v1_genomic.gbff.gz,"Klebsiella michiganensis strain TUM13840 NODE_1_length_125653_cov_17.538685, whole genome shotgun sequence",1,,1,0,1
GCF_030359025.1_ASM3035902v1_genomic.gbff.gz,"Klebsiella michiganensis strain TUM13838 NODE_1_length_171056_cov_15.300125, whole genome shotgun sequence",1,,1,0,1
GCF_030359045.1_ASM3035904v1_genomic.gbff.gz,"Klebsiella michiganensis strain TUM13839 NODE_1_length_160715_cov_17.699785, whole genome shotgun sequence",1,,1,0,1
GCF_030359065.1_ASM3035906v1_genomic.gbff.gz,"Klebsiella michiganensis strain TUM13836 NODE_1_length_224223_cov_16.547007, whole genome shotgun sequence",1,,1,0,1
GCF_030359085.1_ASM3035908v1_genomic.gbff.gz,"Klebsiella michiganensis strain TUM13835 NODE_1_length_192564_cov_20.403779, whole genome shotgun sequence",1,,1,0,1
GCF_030359105.1_ASM3035910v1_genomic.gbff.gz,"Klebsiella michiganensis strain TUM13832 NODE_1_length_136216_cov_15.549339, whole genome shotgun sequence",1,,1,0,1
GCF_030359125.1_ASM3035912v1_genomic.gbff.gz,"Klebsiella michiganensis strain TUM13837 NODE_1_length_222680_cov_14.5966, whole genome shotgun sequence",1,,1,0,1
GCF_030359145.1_ASM3035914v1_genomic.gbff.gz,"Klebsiella michiganensis strain TUM13834 NODE_1_length_253051_cov_24.3232, whole genome shotgun sequence",1,,1,0,1
GCF_030359155.1_ASM3035915v1_genomic.gbff.gz,"Klebsiella michiganensis strain TUM13833 NODE_1_length_215210_cov_23.2195, whole genome shotgun sequence",1,,1,0,1
GCF_030359185.1_ASM3035918v1_genomic.gbff.gz,"Klebsiella michiganensis strain TUM13830 NODE_1_length_215132_cov_21.2815, whole genome shotgun sequence",1,,1,0,1
GCF_030359205.1_ASM3035920v1_genomic.gbff.gz,"Klebsiella michiganensis strain TUM13831 NODE_1_length_193185_cov_18.191916, whole genome shotgun sequence",1,,1,0,1
GCF_030359225.1_ASM3035922v1_genomic.gbff.gz,"Klebsiella michiganensis strain TUM13829 NODE_1_length_223121_cov_25.1641, whole genome shotgun sequence",1,,1,0,1
GCF_030359245.1_ASM3035924v1_genomic.gbff.gz,"Klebsiella michiganensis strain TUM13825 NODE_1_length_305216_cov_22.5781, whole genome shotgun sequence",1,,1,0,1
GCF_030359265.1_ASM3035926v1_genomic.gbff.gz,"Klebsiella michiganensis strain TUM13828 NODE_1_length_165616_cov_22.184568, whole genome shotgun sequence",1,,1,0,1
GCF_030359285.1_ASM3035928v1_genomic.gbff.gz,"Klebsiella michiganensis strain TUM13827 NODE_1_length_160210_cov_22.8334, whole genome shotgun sequence",1,,1,0,1
GCF_030359305.1_ASM3035930v1_genomic.gbff.gz,"Klebsiella michiganensis strain TUM13826 NODE_1_length_143559_cov_18.3132, whole genome shotgun sequence",1,,1,0,1
GCF_030359405.1_ASM3035940v1_genomic.gbff.gz,"Klebsiella michiganensis strain TUM13824 NODE_1_length_121797_cov_16.1503, whole genome shotgun sequence",1,,1,0,1
GCF_030359985.1_ASM3035998v1_genomic.gbff.gz,"Klebsiella grimontii strain TUM13776 NODE_1_length_72003_cov_7.68056, whole genome shotgun sequence",1,,1,0,1
GCF_030360065.1_ASM3036006v1_genomic.gbff.gz,"Klebsiella grimontii strain TUM13777 NODE_1_length_96728_cov_10.2543, whole genome shotgun sequence",1,,1,0,1
GCF_030360115.1_ASM3036011v1_genomic.gbff.gz,"Klebsiella grimontii strain TUM13749 NODE_1_length_76027_cov_8.410856, whole genome shotgun sequence",1,,1,0,1
GCF_030360165.1_ASM3036016v1_genomic.gbff.gz,"Klebsiella grimontii strain TUM13748 NODE_1_length_66164_cov_7.4757, whole genome shotgun sequence",1,,1,0,1
GCF_030361415.1_ASM3036141v1_genomic.gbff.gz,"Klebsiella oxytoca strain NMI588_12 NODE_1_length_354715_cov_43.076728, whole genome shotgun sequence",0,All rRNA sequences shorter than 1400 bases,0,0
GCF_030369335.1_ASM3036933v1_genomic.gbff.gz,"Klebsiella michiganensis strain TUM13905 NODE_1_length_215851_cov_14.734040, whole genome shotgun sequence",1,,1,0,1
GCF_030490325.1_ASM3049032v1_genomic.gbff.gz,Klebsiella michiganensis strain 9152 chromosome,1,,1,0,1
GCF_030490345.1_ASM3049034v1_genomic.gbff.gz,Klebsiella michiganensis strain RSM5061 chromosome,1,,1,0,1
GCF_030506015.1_ASM3050601v1_genomic.gbff.gz,Klebsiella oxytoca strain RSM6895 chromosome,1,,1,0,1
GCF_030506035.1_ASM3050603v1_genomic.gbff.gz,Klebsiella oxytoca strain RSM6774 chromosome,1,,1,0,1
GCF_030518375.1_ASM3051837v1_genomic.gbff.gz,"Klebsiella oxytoca strain RSM5033 RSM5033_scaffold_1, whole genome shotgun sequence",0,No matching 16S rRNA product criteria,0,0
GCF_030518375.2_ASM3051837v2_genomic.gbff.gz,Klebsiella oxytoca strain RSM5033 chromosome,0,No matching 16S rRNA product criteria,0,0
GCF_030542275.1_ASM3054227v1_genomic.gbff.gz,"Klebsiella michiganensis strain C818-2 NODE_100_length_265_cov_95.638298, whole genome shotgun sequence",0,All rRNA sequences shorter than 1400 bases,0,0
GCF_030542365.1_ASM3054236v1_genomic.gbff.gz,"Klebsiella michiganensis strain C289-1 NODE_100_length_770_cov_542.968254, whole genome shotgun sequence",0,All rRNA sequences shorter than 1400 bases,0,0
GCF_030542385.1_ASM3054238v1_genomic.gbff.gz,"Klebsiella michiganensis strain C118-2 NODE_100_length_1133_cov_206.298295, whole genome shotgun sequence",0,All rRNA sequences shorter than 1400 bases,0,0
GCF_030542395.1_ASM3054239v1_genomic.gbff.gz,"Klebsiella michiganensis strain C616-2 NODE_100_length_354_cov_531.140794, whole genome shotgun sequence",0,All rRNA sequences shorter than 1400 bases,0,0
GCF_030542425.1_ASM3054242v1_genomic.gbff.gz,"Klebsiella michiganensis strain M818-2 NODE_100_length_1093_cov_120.676181, whole genome shotgun sequence",0,All rRNA sequences shorter than 1400 bases,0,0
GCF_030544885.1_ASM3054488v1_genomic.gbff.gz,Klebsiella oxytoca strain RSM5034 chromosome,1,,1,0,1
GCF_030658935.1_ASM3065893v1_genomic.gbff.gz,"Klebsiella oxytoca strain KMB-1248 NODE_10_length_179066_cov_65.905877, whole genome shotgun sequence",1,,1,0,1
GCF_030717465.1_ASM3071746v1_genomic.gbff.gz,Klebsiella michiganensis strain RSM7756 chromosome,1,,1,0,1
GCF_030850045.1_ASM3085004v1_genomic.gbff.gz,"Klebsiella michiganensis strain 2023EL-00796 NODE_10_length_242490_cov_35.091817, whole genome shotgun sequence",1,,1,0,1
GCF_030850055.1_ASM3085005v1_genomic.gbff.gz,"Klebsiella pasteurii strain 2023EL-00795 NODE_10_length_216799_cov_39.769855, whole genome shotgun sequence",0,All rRNA sequences shorter than 1400 bases,0,0
GCF_030850095.1_ASM3085009v1_genomic.gbff.gz,"Klebsiella pasteurii strain 2023EL-00797 NODE_10_length_184740_cov_45.107024, whole genome shotgun sequence",0,All rRNA sequences shorter than 1400 bases,0,0
GCF_030850165.1_ASM3085016v1_genomic.gbff.gz,"Klebsiella pasteurii strain 2023EL-00790 NODE_10_length_185515_cov_28.106803, whole genome shotgun sequence",0,All rRNA sequences shorter than 1400 bases,0,0
GCF_030851535.1_ASM3085153v1_genomic.gbff.gz,"Klebsiella michiganensis strain LACPHL-BACT-2023-00033 contig00001, whole genome shotgun sequence",0,No matching 16S rRNA product criteria,0,0
GCF_030913565.1_ASM3091356v1_genomic.gbff.gz,"Klebsiella michiganensis strain 9273 1055300001, whole genome shotgun sequence",1,,1,0,1
GCF_031081595.1_ASM3108159v1_genomic.gbff.gz,"Klebsiella michiganensis strain CCRMKO592 contig00001, whole genome shotgun sequence",0,All rRNA sequences shorter than 1400 bases,0,0
GCF_031316335.1_ASM3131633v1_genomic.gbff.gz,"Klebsiella grimontii strain 2017E043892A 2017E043892A-17_1, whole genome shotgun sequence",1,,1,0,1
GCF_031593235.1_ASM3159323v1_genomic.gbff.gz,Klebsiella pasteurii strain CM-1 chromosome,8,,7,1,1
GCF_031799435.1_ASM3179943v1_genomic.gbff.gz,"Klebsiella oxytoca strain HD8859 NODE_1_length_476749_cov_104.376659, whole genome shotgun sequence",0,All rRNA sequences shorter than 1400 bases,0,0
GCF_031799455.1_ASM3179945v1_genomic.gbff.gz,"Klebsiella michiganensis strain HD7768 NODE_1_length_537473_cov_135.036895, whole genome shotgun sequence",0,All rRNA sequences shorter than 1400 bases,0,0
GCF_031799495.1_ASM3179949v1_genomic.gbff.gz,"Klebsiella michiganensis strain HD8405 HD8405__NODE_1_length_508602_cov_106.371101, whole genome shotgun sequence",0,All rRNA sequences shorter than 1400 bases,0,0
GCF_031799515.1_ASM3179951v1_genomic.gbff.gz,"Klebsiella michiganensis strain HD7566 HD7566__NODE_1_length_500751_cov_68.344106, whole genome shotgun sequence",0,All rRNA sequences shorter than 1400 bases,0,0
GCF_031799575.1_ASM3179957v1_genomic.gbff.gz,"Klebsiella michiganensis strain HD7525 HD7525__NODE_1_length_644894_cov_83.917426, whole genome shotgun sequence",1,,1,0,1
GCF_031799615.1_ASM3179961v1_genomic.gbff.gz,"Klebsiella michiganensis strain HD6915 HD_6915__NODE_1_length_562178_cov_73.139548, whole genome shotgun sequence",0,All rRNA sequences shorter than 1400 bases,0,0
GCF_031799655.1_ASM3179965v1_genomic.gbff.gz,"Klebsiella oxytoca strain HD4353 HD4353__NODE_1_length_509957_cov_87.201330, whole genome shotgun sequence",0,All rRNA sequences shorter than 1400 bases,0,0
GCF_031799735.1_ASM3179973v1_genomic.gbff.gz,"Klebsiella michiganensis strain HD3867 HD_3867__NODE_1_length_691809_cov_102.822155, whole genome shotgun sequence",0,All rRNA sequences shorter than 1400 bases,0,0
GCF_031799755.1_ASM3179975v1_genomic.gbff.gz,"Klebsiella michiganensis strain HD3873 HD3873__NODE_1_length_794734_cov_153.004515, whole genome shotgun sequence",0,All rRNA sequences shorter than 1400 bases,0,0
GCF_031799765.1_ASM3179976v1_genomic.gbff.gz,"Klebsiella michiganensis strain HD3097 HD3097__NODE_1_length_728909_cov_97.351934, whole genome shotgun sequence",0,All rRNA sequences shorter than 1400 bases,0,0
GCF_031799795.1_ASM3179979v1_genomic.gbff.gz,"Klebsiella oxytoca strain HD2708 HD2708__NODE_1_length_655808_cov_94.731889, whole genome shotgun sequence",0,All rRNA sequences shorter than 1400 bases,0,0
GCF_031799835.1_ASM3179983v1_genomic.gbff.gz,"Klebsiella pasteurii strain HD2349 2349__NODE_1_length_634254_cov_68.200856, whole genome shotgun sequence",0,All rRNA sequences shorter than 1400 bases,0,0
GCF_031799915.1_ASM3179991v1_genomic.gbff.gz,"Klebsiella michiganensis strain HD1352 HD1352__1, whole genome shotgun sequence",0,All rRNA sequences shorter than 1400 bases,0,0
GCF_031799955.1_ASM3179995v1_genomic.gbff.gz,"Klebsiella michiganensis strain HD1344 HD1344__1, whole genome shotgun sequence",0,All rRNA sequences shorter than 1400 bases,0,0
GCF_031799975.1_ASM3179997v1_genomic.gbff.gz,"Klebsiella oxytoca strain HD5230 HD_5230__NODE_1_length_441073_cov_124.663240, whole genome shotgun sequence",0,All rRNA sequences shorter than 1400 bases,0,0
GCF_031799995.1_ASM3179999v1_genomic.gbff.gz,"Klebsiella michiganensis strain HD1688 HD1688__1, whole genome shotgun sequence",0,All rRNA sequences shorter than 1400 bases,0,0
GCF_031800055.1_ASM3180005v1_genomic.gbff.gz,"Klebsiella michiganensis strain HD2871 HD2871__NODE_1_length_728884_cov_112.464931, whole genome shotgun sequence",0,All rRNA sequences shorter than 1400 bases,0,0
GCF_031800115.1_ASM3180011v1_genomic.gbff.gz,"Klebsiella michiganensis strain HD4543 HD4543__NODE_1_length_508990_cov_140.261986, whole genome shotgun sequence",0,All rRNA sequences shorter than 1400 bases,0,0
GCF_031800135.1_ASM3180013v1_genomic.gbff.gz,"Klebsiella michiganensis strain HD6177 HD6177__NODE_1_length_387697_cov_110.628482, whole genome shotgun sequence",0,All rRNA sequences shorter than 1400 bases,0,0
GCF_031800155.1_ASM3180015v1_genomic.gbff.gz,"Klebsiella pasteurii strain HD7419 HD7419__F676__NODE_1_length_859533_cov_61.253178, whole genome shotgun sequence",1,,1,0,1
GCF_031800225.1_ASM3180022v1_genomic.gbff.gz,"Klebsiella pasteurii strain HD6089 HD6089__NODE_1_length_804293_cov_118.163582, whole genome shotgun sequence",0,All rRNA sequences shorter than 1400 bases,0,0
GCF_031800275.1_ASM3180027v1_genomic.gbff.gz,"Klebsiella michiganensis strain HD4379 HD4379__NODE_1_length_829627_cov_109.247265, whole genome shotgun sequence",0,All rRNA sequences shorter than 1400 bases,0,0
GCF_031800315.1_ASM3180031v1_genomic.gbff.gz,"Klebsiella michiganensis strain HD2691 HD2691__NODE_1_length_295959_cov_115.152716, whole genome shotgun sequence",0,All rRNA sequences shorter than 1400 bases,0,0
GCF_031800355.1_ASM3180035v1_genomic.gbff.gz,"Klebsiella oxytoca strain HD2641 HD2641__NODE_1_length_507812_cov_116.356316, whole genome shotgun sequence",1,,1,0,1
GCF_031800375.1_ASM3180037v1_genomic.gbff.gz,"Klebsiella pasteurii strain HD1962 HD1962__NODE_1_length_1266041_cov_110.601690, whole genome shotgun sequence",0,All rRNA sequences shorter than 1400 bases,0,0
GCF_032290465.1_ASM3229046v1_genomic.gbff.gz,"Klebsiella grimontii strain LACPHL-BACT-2023-00082 contig00001, whole genome shotgun sequence",0,No matching 16S rRNA product criteria,0,0
GCF_032461035.1_ASM3246103v1_genomic.gbff.gz,"Klebsiella oxytoca strain INSA49888 Ko49888p_1, whole genome shotgun sequence",0,All rRNA sequences shorter than 1400 bases,0,0
GCF_032670645.1_ASM3267064v1_genomic.gbff.gz,"Klebsiella grimontii strain H880 NODE_1_length_339617_cov_30.782482, whole genome shotgun sequence",0,All rRNA sequences shorter than 1400 bases,0,0
GCF_032670665.1_ASM3267066v1_genomic.gbff.gz,"Klebsiella michiganensis strain H809 NODE_1_length_268054_cov_24.797471, whole genome shotgun sequence",0,All rRNA sequences shorter than 1400 bases,0,0
GCF_032670685.1_ASM3267068v1_genomic.gbff.gz,"Klebsiella michiganensis strain H365 NODE_1_length_234339_cov_30.174753, whole genome shotgun sequence",0,All rRNA sequences shorter than 1400 bases,0,0
GCF_032670725.1_ASM3267072v1_genomic.gbff.gz,"Klebsiella grimontii strain H459 NODE_1_length_367258_cov_32.184075, whole genome shotgun sequence",0,All rRNA sequences shorter than 1400 bases,0,0
GCF_032670805.1_ASM3267080v1_genomic.gbff.gz,"Klebsiella grimontii strain H488 NODE_1_length_296726_cov_36.299725, whole genome shotgun sequence",0,All rRNA sequences shorter than 1400 bases,0,0
GCF_032670825.1_ASM3267082v1_genomic.gbff.gz,"Klebsiella oxytoca strain H611 NODE_1_length_432055_cov_29.683192, whole genome shotgun sequence",0,All rRNA sequences shorter than 1400 bases,0,0
GCF_032670845.1_ASM3267084v1_genomic.gbff.gz,"Klebsiella grimontii strain H480 NODE_1_length_406723_cov_46.046534, whole genome shotgun sequence",0,All rRNA sequences shorter than 1400 bases,0,0
GCF_032670895.1_ASM3267089v1_genomic.gbff.gz,"Klebsiella grimontii strain A273 NODE_1_length_333838_cov_52.441771, whole genome shotgun sequence",0,All rRNA sequences shorter than 1400 bases,0,0
GCF_032670945.1_ASM3267094v1_genomic.gbff.gz,"Klebsiella oxytoca strain H623 NODE_1_length_544879_cov_39.736205, whole genome shotgun sequence",0,All rRNA sequences shorter than 1400 bases,0,0
GCF_032671005.1_ASM3267100v1_genomic.gbff.gz,"Klebsiella oxytoca strain A114 NODE_1_length_1110883_cov_34.454716, whole genome shotgun sequence",0,All rRNA sequences shorter than 1400 bases,0,0
GCF_032671025.1_ASM3267102v1_genomic.gbff.gz,"Klebsiella michiganensis strain A073 NODE_1_length_460318_cov_54.575372, whole genome shotgun sequence",0,All rRNA sequences shorter than 1400 bases,0,0
GCF_032671045.1_ASM3267104v1_genomic.gbff.gz,"Klebsiella oxytoca strain A006 NODE_1_length_617609_cov_48.504680, whole genome shotgun sequence",0,All rRNA sequences shorter than 1400 bases,0,0
GCF_032671085.1_ASM3267108v1_genomic.gbff.gz,"Klebsiella oxytoca strain 6184 NODE_1_length_648899_cov_45.359715, whole genome shotgun sequence",0,All rRNA sequences shorter than 1400 bases,0,0
GCF_032671165.1_ASM3267116v1_genomic.gbff.gz,"Klebsiella michiganensis strain 2437 NODE_1_length_448496_cov_48.077004, whole genome shotgun sequence",1,,1,0,1
GCF_032671185.1_ASM3267118v1_genomic.gbff.gz,"Klebsiella michiganensis strain 2294 NODE_1_length_357036_cov_66.992551, whole genome shotgun sequence",0,All rRNA sequences shorter than 1400 bases,0,0
GCF_032671225.1_ASM3267122v1_genomic.gbff.gz,"Klebsiella oxytoca strain 2023 NODE_1_length_799038_cov_47.258352, whole genome shotgun sequence",0,All rRNA sequences shorter than 1400 bases,0,0
GCF_032671245.1_ASM3267124v1_genomic.gbff.gz,"Klebsiella michiganensis strain 2297 NODE_1_length_617378_cov_40.738841, whole genome shotgun sequence",0,All rRNA sequences shorter than 1400 bases,0,0
GCF_032676685.1_ASM3267668v1_genomic.gbff.gz,"Klebsiella michiganensis strain INSA56361 Ko56361_S13p_1, whole genome shotgun sequence",1,,1,0,1
GCF_032676705.1_ASM3267670v1_genomic.gbff.gz,"Klebsiella michiganensis strain INSA48911 Ko48911p_1, whole genome shotgun sequence",0,All rRNA sequences shorter than 1400 bases,0,0
GCF_032676725.1_ASM3267672v1_genomic.gbff.gz,"Klebsiella grimontii strain INSA57168 Ko57168_1_S17p_1, whole genome shotgun sequence",0,All rRNA sequences shorter than 1400 bases,0,0
GCF_032676825.1_ASM3267682v1_genomic.gbff.gz,"Klebsiella grimontii strain INSA57231 Ko57231_S18p_1, whole genome shotgun sequence",0,All rRNA sequences shorter than 1400 bases,0,0
GCF_032676845.1_ASM3267684v1_genomic.gbff.gz,"Klebsiella michiganensis strain INSAA1694 AA1694p_1, whole genome shotgun sequence",0,All rRNA sequences shorter than 1400 bases,0,0
GCF_032676965.1_ASM3267696v1_genomic.gbff.gz,"Klebsiella michiganensis strain INSAA1688 KoBH38_S14p_1, whole genome shotgun sequence",0,All rRNA sequences shorter than 1400 bases,0,0
GCF_032677005.1_ASM3267700v1_genomic.gbff.gz,"Klebsiella michiganensis strain INSAA1696 AA1696p_1, whole genome shotgun sequence",0,All rRNA sequences shorter than 1400 bases,0,0
GCF_032677065.1_ASM3267706v1_genomic.gbff.gz,"Klebsiella grimontii strain INSA57166 Ko57166_S15p_1, whole genome shotgun sequence",0,All rRNA sequences shorter than 1400 bases,0,0
GCF_032677145.1_ASM3267714v1_genomic.gbff.gz,"Klebsiella grimontii strain INSA57232 Ko57232_2_S19p_1, whole genome shotgun sequence",1,,1,0,1
GCF_032677205.1_ASM3267720v1_genomic.gbff.gz,"Klebsiella grimontii strain INSA57167 Ko57167_S16p_1, whole genome shotgun sequence",1,,1,0,1
GCF_032677265.1_ASM3267726v1_genomic.gbff.gz,"Klebsiella pasteurii strain ZZV20-11045 NODE_1_length_507009_cov_19.901001, whole genome shotgun sequence",0,All rRNA sequences shorter than 1400 bases,0,0
GCF_032677325.1_ASM3267732v1_genomic.gbff.gz,"Klebsiella oxytoca strain 12-8430-21 NODE_1_length_501007_cov_19.285561, whole genome shotgun sequence",0,All rRNA sequences shorter than 1400 bases,0,0
GCF_032677365.1_ASM3267736v1_genomic.gbff.gz,"Klebsiella grimontii strain 12-19119-21 NODE_1_length_808520_cov_22.309082, whole genome shotgun sequence",1,,1,0,1
GCF_032677405.1_ASM3267740v1_genomic.gbff.gz,"Klebsiella michiganensis strain 12-12518-20 NODE_1_length_641385_cov_20.055123, whole genome shotgun sequence",0,All rRNA sequences shorter than 1400 bases,0,0
GCF_032677425.1_ASM3267742v1_genomic.gbff.gz,"Klebsiella michiganensis strain 04-14752 NODE_1_length_388542_cov_18.757541, whole genome shotgun sequence",0,All rRNA sequences shorter than 1400 bases,0,0
GCF_032677435.1_ASM3267743v1_genomic.gbff.gz,"Klebsiella grimontii strain ZZV20-11046 NODE_1_length_500673_cov_35.702712, whole genome shotgun sequence",0,All rRNA sequences shorter than 1400 bases,0,0
GCF_032677545.1_ASM3267754v1_genomic.gbff.gz,"Klebsiella oxytoca strain 12-5816-22 NODE_1_length_493771_cov_22.337586, whole genome shotgun sequence",0,All rRNA sequences shorter than 1400 bases,0,0
GCF_032677565.1_ASM3267756v1_genomic.gbff.gz,"Klebsiella michiganensis strain 12-10889-22 NODE_1_length_929951_cov_20.512575, whole genome shotgun sequence",0,No matching 16S rRNA product criteria,0,0
GCF_032677575.1_ASM3267757v1_genomic.gbff.gz,"Klebsiella grimontii strain ZZV20-11058 NODE_1_length_419107_cov_19.284490, whole genome shotgun sequence",0,No matching 16S rRNA product criteria,0,0
GCF_032742035.1_ASM3274203v1_genomic.gbff.gz,"Klebsiella pasteurii strain 23-M-SD-108 NODE_1_length_846511_cov_63.941793, whole genome shotgun sequence",0,All rRNA sequences shorter than 1400 bases,0,0
GCF_032742175.1_ASM3274217v1_genomic.gbff.gz,"Klebsiella pasteurii strain 23-M-RB-89 NODE_1_length_465573_cov_72.664473, whole genome shotgun sequence",1,,1,0,1
GCF_032742375.1_ASM3274237v1_genomic.gbff.gz,"Klebsiella grimontii strain 23-M-RB-87 NODE_1_length_515471_cov_68.066361, whole genome shotgun sequence",0,All rRNA sequences shorter than 1400 bases,0,0
GCF_032742395.1_ASM3274239v1_genomic.gbff.gz,"Klebsiella pasteurii strain 23-M-RB-86 NODE_1_length_465840_cov_68.854984, whole genome shotgun sequence",0,All rRNA sequences shorter than 1400 bases,0,0
GCF_032742415.1_ASM3274241v1_genomic.gbff.gz,"Klebsiella grimontii strain 23-M-RB-85 NODE_1_length_515677_cov_75.433662, whole genome shotgun sequence",0,All rRNA sequences shorter than 1400 bases,0,0
GCF_032742455.1_ASM3274245v1_genomic.gbff.gz,"Klebsiella grimontii strain 23-M-RB-83 NODE_1_length_515469_cov_73.481302, whole genome shotgun sequence",0,All rRNA sequences shorter than 1400 bases,0,0
GCF_032742475.1_ASM3274247v1_genomic.gbff.gz,"Klebsiella grimontii strain 23-M-RB-78 NODE_1_length_515677_cov_73.182531, whole genome shotgun sequence",0,All rRNA sequences shorter than 1400 bases,0,0
GCF_032742495.1_ASM3274249v1_genomic.gbff.gz,"Klebsiella grimontii strain 23-M-RB-80 NODE_1_length_371727_cov_84.573919, whole genome shotgun sequence",0,All rRNA sequences shorter than 1400 bases,0,0
GCF_032742515.1_ASM3274251v1_genomic.gbff.gz,"Klebsiella grimontii strain 23-M-RB-30 NODE_1_length_515679_cov_67.611848, whole genome shotgun sequence",0,All rRNA sequences shorter than 1400 bases,0,0
GCF_032743195.1_ASM3274319v1_genomic.gbff.gz,"Klebsiella michiganensis strain 23-M-LY-19 NODE_1_length_638858_cov_74.018764, whole genome shotgun sequence",0,All rRNA sequences shorter than 1400 bases,0,0
GCF_032743635.1_ASM3274363v1_genomic.gbff.gz,"Klebsiella grimontii strain 23-M-RB-26 NODE_1_length_515679_cov_70.099398, whole genome shotgun sequence",0,All rRNA sequences shorter than 1400 bases,0,0
GCF_032744695.1_ASM3274469v1_genomic.gbff.gz,"Klebsiella michiganensis strain 23-C-YW-49-1 NODE_1_length_426895_cov_85.363719, whole genome shotgun sequence",0,All rRNA sequences shorter than 1400 bases,0,0
GCF_032744755.1_ASM3274475v1_genomic.gbff.gz,"Klebsiella michiganensis strain 23-C-YW-24 NODE_1_length_427235_cov_73.030738, whole genome shotgun sequence",0,All rRNA sequences shorter than 1400 bases,0,0
GCF_032745295.1_ASM3274529v1_genomic.gbff.gz,"Klebsiella michiganensis strain 23-C-SZ-85-1 NODE_1_length_1603997_cov_79.039885, whole genome shotgun sequence",0,All rRNA sequences shorter than 1400 bases,0,0
GCF_032745375.1_ASM3274537v1_genomic.gbff.gz,"Klebsiella michiganensis strain 23-C-SZ-33 NODE_1_length_1136067_cov_85.495217, whole genome shotgun sequence",0,All rRNA sequences shorter than 1400 bases,0,0
GCF_032746275.1_ASM3274627v1_genomic.gbff.gz,"Klebsiella pasteurii strain 23-C-LY-9 NODE_1_length_523418_cov_68.220283, whole genome shotgun sequence",0,All rRNA sequences shorter than 1400 bases,0,0
GCF_032746355.1_ASM3274635v1_genomic.gbff.gz,"Klebsiella pasteurii strain 23-C-LY-23 NODE_1_length_523126_cov_69.136547, whole genome shotgun sequence",0,All rRNA sequences shorter than 1400 bases,0,0
GCF_032746795.1_ASM3274679v1_genomic.gbff.gz,"Klebsiella michiganensis strain 23-C-JX-72 NODE_1_length_427147_cov_87.956649, whole genome shotgun sequence",0,All rRNA sequences shorter than 1400 bases,0,0
GCF_032803765.1_ASM3280376v1_genomic.gbff.gz,"Klebsiella grimontii strain 23-M-RB-84 NODE_1_length_515469_cov_73.672795, whole genome shotgun sequence",0,All rRNA sequences shorter than 1400 bases,0,0
GCF_033031495.1_ASM3303149v1_genomic.gbff.gz,"Klebsiella michiganensis strain PP-E732.3 1, whole genome shotgun sequence",8,,7,1,2
GCF_033031515.1_ASM3303151v1_genomic.gbff.gz,"Klebsiella michiganensis strain PP-E700.2B 1, whole genome shotgun sequence",8,,8,0,2
GCF_033031585.1_ASM3303158v1_genomic.gbff.gz,"Klebsiella michiganensis strain PP-E660.1 1, whole genome shotgun sequence",8,,7,1,2
GCF_033099835.1_ASM3309983v1_genomic.gbff.gz,"Klebsiella michiganensis strain 2023EL-00972 NODE_1_length_714078_cov_40.212652, whole genome shotgun sequence",1,,1,0,1
GCF_033099855.1_ASM3309985v1_genomic.gbff.gz,"Klebsiella pasteurii strain 2023EL-00971 NODE_1_length_539840_cov_24.231182, whole genome shotgun sequence",0,All rRNA sequences shorter than 1400 bases,0,0
GCF_033237845.1_ASM3323784v1_genomic.gbff.gz,"Klebsiella michiganensis strain ARS-CC16637 NODE_1_length_225065_cov_21.826969, whole genome shotgun sequence",0,All rRNA sequences shorter than 1400 bases,0,0
GCF_033342075.1_ASM3334207v1_genomic.gbff.gz,"Klebsiella pasteurii strain HN-157 NODE_1_length_555962_cov_75.846645, whole genome shotgun sequence",0,All rRNA sequences shorter than 1400 bases,0,0
GCF_033345475.1_ASM3334547v1_genomic.gbff.gz,"Klebsiella michiganensis strain 2023EL-01145 NODE_100_length_1211_cov_728.480627, whole genome shotgun sequence",0,All rRNA sequences shorter than 1400 bases,0,0
GCF_033345505.1_ASM3334550v1_genomic.gbff.gz,"Klebsiella michiganensis strain 2023EL-01144 NODE_100_length_767_cov_3.443750, whole genome shotgun sequence",0,All rRNA sequences shorter than 1400 bases,0,0
GCF_033447165.1_ASM3344716v1_genomic.gbff.gz,"Klebsiella michiganensis strain 2023EL-01197 NODE_10_length_259956_cov_44.057957, whole genome shotgun sequence",1,,1,0,1
GCF_033447175.1_ASM3344717v1_genomic.gbff.gz,"Klebsiella michiganensis strain 2023EL-01196 NODE_10_length_261924_cov_32.570610, whole genome shotgun sequence",1,,1,0,1
GCF_033860475.1_ASM3386047v1_genomic.gbff.gz,"Klebsiella oxytoca strain SRY435 chromosome, complete genome",8,,8,0,2
GCF_033864495.1_ASM3386449v1_genomic.gbff.gz,"Klebsiella oxytoca strain 86 chromosome, complete genome",8,,8,0,2
GCF_033865735.1_ASM3386573v1_genomic.gbff.gz,"Klebsiella oxytoca strain 45 chromosome, complete genome",8,,5,3,1
GCF_033898965.1_ASM3389896v1_genomic.gbff.gz,"Klebsiella oxytoca strain CIM-Cont-039 NODE_1_length_768546_cov_86.781875, whole genome shotgun sequence",0,All rRNA sequences shorter than 1400 bases,0,0
GCF_033899885.1_ASM3389988v1_genomic.gbff.gz,"Klebsiella pasteurii strain CIM-Carb-131 NODE_100_length_205_cov_162.757812, whole genome shotgun sequence",1,,1,0,1
GCF_033899945.1_ASM3389994v1_genomic.gbff.gz,"Klebsiella oxytoca strain CIM-Carb-126 NODE_100_length_317_cov_143.654167, whole genome shotgun sequence",0,All rRNA sequences shorter than 1400 bases,0,0
GCF_034427635.1_ASM3442763v1_genomic.gbff.gz,"Klebsiella michiganensis strain 2023EL-01212 NODE_1_length_553662_cov_42.976283, whole genome shotgun sequence",1,,1,0,1
GCF_034427675.1_ASM3442767v1_genomic.gbff.gz,"Klebsiella michiganensis strain 2023EL-01216 NODE_1_length_426363_cov_46.033592, whole genome shotgun sequence",0,All rRNA sequences shorter than 1400 bases,0,0
GCF_034427715.1_ASM3442771v1_genomic.gbff.gz,"Klebsiella pasteurii strain 2023EL-01214 NODE_1_length_854319_cov_43.224563, whole genome shotgun sequence",0,All rRNA sequences shorter than 1400 bases,0,0
GCF_034506895.1_ASM3450689v1_genomic.gbff.gz,"Klebsiella oxytoca strain 2023EL-01221 NODE_10_length_237125_cov_48.756901, whole genome shotgun sequence",1,,1,0,1
GCF_035284165.1_ASM3528416v1_genomic.gbff.gz,"Klebsiella oxytoca strain A18 contig00001, whole genome shotgun sequence",0,All rRNA sequences shorter than 1400 bases,0,0
GCF_035284175.1_ASM3528417v1_genomic.gbff.gz,"Klebsiella oxytoca strain A22 contig00001, whole genome shotgun sequence",0,All rRNA sequences shorter than 1400 bases,0,0
GCF_035284205.1_ASM3528420v1_genomic.gbff.gz,"Klebsiella oxytoca strain I3 contig00001, whole genome shotgun sequence",0,All rRNA sequences shorter than 1400 bases,0,0
GCF_035786615.1_ASM3578661v1_genomic.gbff.gz,"Klebsiella michiganensis strain NHS4mu contig00001, whole genome shotgun sequence",0,All rRNA sequences shorter than 1400 bases,0,0
GCF_035786855.1_ASM3578685v1_genomic.gbff.gz,"Klebsiella oxytoca strain NNS8 contig00001, whole genome shotgun sequence",0,All rRNA sequences shorter than 1400 bases,0,0
GCF_035786895.1_ASM3578689v1_genomic.gbff.gz,"Klebsiella oxytoca strain NHS7lp contig00001, whole genome shotgun sequence",0,All rRNA sequences shorter than 1400 bases,0,0
GCF_035787195.1_ASM3578719v1_genomic.gbff.gz,"Klebsiella michiganensis strain MGG-8mu contig00001, whole genome shotgun sequence",1,,1,0,1
GCF_035792875.1_ASM3579287v1_genomic.gbff.gz,"Klebsiella grimontii strain Sil RS 27 contig00001, whole genome shotgun sequence",0,All rRNA sequences shorter than 1400 bases,0,0
GCF_035792955.1_ASM3579295v1_genomic.gbff.gz,"Klebsiella michiganensis strain Sil NS 45 contig00001, whole genome shotgun sequence",0,All rRNA sequences shorter than 1400 bases,0,0
GCF_035793375.1_ASM3579337v1_genomic.gbff.gz,"Klebsiella michiganensis strain Sil NS 34 contig00001, whole genome shotgun sequence",0,All rRNA sequences shorter than 1400 bases,0,0
GCF_035794755.1_ASM3579475v1_genomic.gbff.gz,"Klebsiella oxytoca strain Ngtc RS 28 contig00001, whole genome shotgun sequence",0,All rRNA sequences shorter than 1400 bases,0,0
GCF_035795375.1_ASM3579537v1_genomic.gbff.gz,"Klebsiella michiganensis strain Ngtc NS 21 contig00001, whole genome shotgun sequence",0,All rRNA sequences shorter than 1400 bases,0,0
GCF_035797335.1_ASM3579733v1_genomic.gbff.gz,"Klebsiella grimontii strain Gar RS 18 contig00001, whole genome shotgun sequence",0,All rRNA sequences shorter than 1400 bases,0,0
GCF_035797695.1_ASM3579769v1_genomic.gbff.gz,"Klebsiella michiganensis strain Gar NS 17 contig00001, whole genome shotgun sequence",0,All rRNA sequences shorter than 1400 bases,0,0
GCF_036016465.1_HA21Ko_genomic.gbff.gz,"Klebsiella oxytoca strain HA21Ko NODE_100_length_357_cov_14.143411, whole genome shotgun sequence",0,All rRNA sequences shorter than 1400 bases,0,0
GCF_036016495.1_HA12Ko_genomic.gbff.gz,"Klebsiella oxytoca strain HA12Ko NODE_100_length_360_cov_8.981413, whole genome shotgun sequence",0,All rRNA sequences shorter than 1400 bases,0,0
GCF_036016545.1_HA22pKo_genomic.gbff.gz,"Klebsiella oxytoca strain HA22pKo 1, whole genome shotgun sequence",1,,1,0,1
GCF_036016635.1_HA28pKo_genomic.gbff.gz,"Klebsiella oxytoca strain HA28pKo 1, whole genome shotgun sequence",1,,1,0,1
GCF_036016645.1_HA54Ko_genomic.gbff.gz,"Klebsiella oxytoca strain HA54Ko 1, whole genome shotgun sequence",1,,1,0,1
GCF_036287845.1_ASM3628784v1_genomic.gbff.gz,"Klebsiella pasteurii strain KO200862 chromosome, complete genome",8,,6,2,2
GCF_036324245.1_ASM3632424v1_genomic.gbff.gz,"Klebsiella michiganensis strain KO2008341 plasmid pKO2008341_1_OXA48, whole genome shotgun sequence",8,,8,0,1
GCF_036441055.1_ASM3644105v1_genomic.gbff.gz,"Klebsiella huaxiensis strain 20-M0000649-0 20-MO00649-0_contig_1, whole genome shotgun sequence",1,,1,0,1
GCF_036542565.1_ASM3654256v1_genomic.gbff.gz,"Klebsiella oxytoca strain SCPM-O-B-10401 (C22925/21) 1, whole genome shotgun sequence",0,All rRNA sequences shorter than 1400 bases,0,0
GCF_036543365.1_ASM3654336v1_genomic.gbff.gz,"Klebsiella michiganensis strain SCPM-O-B-10398 (C22841/21) 1, whole genome shotgun sequence",0,All rRNA sequences shorter than 1400 bases,0,0
GCF_036668975.1_ASM3666897v1_genomic.gbff.gz,"Klebsiella grimontii strain ESBL4 NODE_1_length_830859_cov_43.654649, whole genome shotgun sequence",0,All rRNA sequences shorter than 1400 bases,0,0
GCF_036687455.1_ASM3668745v1_genomic.gbff.gz,"Klebsiella oxytoca strain KO190245 chromosome, complete genome",8,,6,2,1
GCF_036880125.1_ASM3688012v1_genomic.gbff.gz,"Klebsiella michiganensis strain GN-078 GN78_contig_1, whole genome shotgun sequence",1,,1,0,1
GCF_036880185.1_ASM3688018v1_genomic.gbff.gz,"Klebsiella michiganensis strain GN-076 GN76_contig_1, whole genome shotgun sequence",1,,1,0,1
GCF_036906935.1_ASM3690693v1_genomic.gbff.gz,"Klebsiella michiganensis strain LACPHL-BACT-2024-00069 contig00001, whole genome shotgun sequence",0,No matching 16S rRNA product criteria,0,0
GCF_036907955.1_ASM3690795v1_genomic.gbff.gz,"Klebsiella michiganensis strain CDS2301 CDS2301_1, whole genome shotgun sequence",1,,1,0,1
GCF_036908015.1_ASM3690801v1_genomic.gbff.gz,"Klebsiella oxytoca strain CDS0301 CDS0301_1, whole genome shotgun sequence",1,,1,0,1
GCF_036911735.1_ASM3691173v1_genomic.gbff.gz,"Klebsiella oxytoca strain CDS7405 CDS7405_1, whole genome shotgun sequence",1,,1,0,1
GCF_036911815.1_ASM3691181v1_genomic.gbff.gz,"Klebsiella michiganensis strain CDS2101 CDS2101_1, whole genome shotgun sequence",1,,1,0,1
GCF_036950865.1_ASM3695086v1_genomic.gbff.gz,"Klebsiella michiganensis strain 1103944 L_1_consensus, whole genome shotgun sequence",0,All rRNA sequences shorter than 1400 bases,0,0
GCF_036951165.1_ASM3695116v1_genomic.gbff.gz,"Klebsiella michiganensis strain 1101458 L_1_consensus, whole genome shotgun sequence",0,All rRNA sequences shorter than 1400 bases,0,0
GCF_036951205.1_ASM3695120v1_genomic.gbff.gz,"Klebsiella michiganensis strain 1101456 L_1_consensus, whole genome shotgun sequence",0,All rRNA sequences shorter than 1400 bases,0,0
GCF_036951965.1_ASM3695196v1_genomic.gbff.gz,"Klebsiella michiganensis strain 1100530 L_1_consensus, whole genome shotgun sequence",0,All rRNA sequences shorter than 1400 bases,0,0
GCF_036952685.1_ASM3695268v1_genomic.gbff.gz,"Klebsiella michiganensis strain 2203528 L_1_consensus, whole genome shotgun sequence",0,All rRNA sequences shorter than 1400 bases,0,0
GCF_036952705.1_ASM3695270v1_genomic.gbff.gz,"Klebsiella michiganensis strain 2203527 L_1_consensus, whole genome shotgun sequence",0,All rRNA sequences shorter than 1400 bases,0,0
GCF_036952745.1_ASM3695274v1_genomic.gbff.gz,"Klebsiella oxytoca strain 2203512 L_1_consensus, whole genome shotgun sequence",0,All rRNA sequences shorter than 1400 bases,0,0
GCF_036958305.1_ASM3695830v1_genomic.gbff.gz,"Klebsiella oxytoca strain 1202756 L_1_consensus, whole genome shotgun sequence",0,All rRNA sequences shorter than 1400 bases,0,0
GCF_037002785.1_ASM3700278v1_genomic.gbff.gz,"Klebsiella grimontii strain K15g NODE_1_length_634196_cov_26.726823, whole genome shotgun sequence",1,,1,0,1
GCF_037030755.1_ASM3703075v1_genomic.gbff.gz,"Klebsiella michiganensis strain KoLESPA_200 accn571.1748.con.0001assembly, whole genome shotgun sequence",1,,1,0,1
GCF_037030875.1_ASM3703087v1_genomic.gbff.gz,"Klebsiella michiganensis strain KoLESPA_188 accn571.1730.con.0001assembly, whole genome shotgun sequence",1,,1,0,1
GCF_037081885.1_ASM3708188v1_genomic.gbff.gz,"Klebsiella michiganensis strain B4.H1.30 chromosome, complete genome",8,,7,1,2
GCF_037081955.1_ASM3708195v1_genomic.gbff.gz,"Klebsiella michiganensis strain B3.H1.24 chromosome, complete genome",8,,7,1,2
GCF_037145475.1_ASM3714547v1_genomic.gbff.gz,"Klebsiella michiganensis strain USHLN157 contig00001, whole genome shotgun sequence",0,All rRNA sequences shorter than 1400 bases,0,0
GCF_037151075.1_ASM3715107v1_genomic.gbff.gz,"Klebsiella oxytoca strain HN162 contig00001, whole genome shotgun sequence",0,All rRNA sequences shorter than 1400 bases,0,0
GCF_037153215.1_ASM3715321v1_genomic.gbff.gz,"Klebsiella michiganensis strain USHLN16 contig00001, whole genome shotgun sequence",1,,1,0,1
GCF_038039645.1_ASM3803964v1_genomic.gbff.gz,"Klebsiella grimontii strain SCPM-O-B-10657 (64827/22) 1, whole genome shotgun sequence",0,All rRNA sequences shorter than 1400 bases,0,0
GCF_038149365.1_ASM3814936v1_genomic.gbff.gz,"Klebsiella oxytoca strain SCPM-O-B-10693 (C49596/22) 1, whole genome shotgun sequence",1,,1,0,1
GCF_038149585.1_ASM3814958v1_genomic.gbff.gz,"Klebsiella oxytoca strain SCPM-O-B-10650 (54154/22) 1, whole genome shotgun sequence",1,,1,0,1
GCF_038185235.1_ASM3818523v1_genomic.gbff.gz,"Klebsiella michiganensis strain Km_Control10 NODE_1_length_422566_cov_17.661, whole genome shotgun sequence",0,All rRNA sequences shorter than 1400 bases,0,0
GCF_038185285.1_ASM3818528v1_genomic.gbff.gz,"Klebsiella grimontii strain Kg_Case5.2 NODE_1_length_458621_cov_14.623572, whole genome shotgun sequence",1,,1,0,1
GCF_038185295.1_ASM3818529v1_genomic.gbff.gz,"Klebsiella michiganensis strain Km_Control5 NODE_1_length_381842_cov_21.1935, whole genome shotgun sequence",1,,1,0,1
GCF_038185335.1_ASM3818533v1_genomic.gbff.gz,"Klebsiella grimontii strain Kg_Case4.2 NODE_1_length_366775_cov_11.047582, whole genome shotgun sequence",1,,1,0,1
GCF_038185415.1_ASM3818541v1_genomic.gbff.gz,"Klebsiella michiganensis strain Km_Case2 NODE_1_length_347389_cov_14.8714, whole genome shotgun sequence",1,,1,0,1
GCF_038185545.1_ASM3818554v1_genomic.gbff.gz,"Klebsiella grimontii strain Kg_Case1 NODE_1_length_756858_cov_13.108243, whole genome shotgun sequence",1,,1,0,1
GCF_038448985.1_ASM3844898v1_genomic.gbff.gz,"Klebsiella michiganensis strain 2024HQ-00017 chromosome, complete genome",8,,8,0,1
GCF_038737695.1_ASM3873769v1_genomic.gbff.gz,"Klebsiella huaxiensis strain UMB11391 assembly_contig_1, whole genome shotgun sequence",1,,1,0,1
GCF_038737825.1_ASM3873782v1_genomic.gbff.gz,"Klebsiella michiganensis strain UMB11423 21_contig_1, whole genome shotgun sequence",1,,1,0,1
GCF_038737875.1_ASM3873787v1_genomic.gbff.gz,"Klebsiella michiganensis strain UMB11142 20_contig_1, whole genome shotgun sequence",1,,1,0,1
GCF_038737905.1_ASM3873790v1_genomic.gbff.gz,"Klebsiella grimontii strain UMB12659 19_contig_1, whole genome shotgun sequence",1,,1,0,1
GCF_038737965.1_ASM3873796v1_genomic.gbff.gz,"Klebsiella grimontii strain UMB12885 18_contig_1, whole genome shotgun sequence",1,,1,0,1
GCF_038738055.1_ASM3873805v1_genomic.gbff.gz,"Klebsiella grimontii strain UMB12529 17_contig_1, whole genome shotgun sequence",1,,1,0,1
GCF_039024105.1_ASM3902410v1_genomic.gbff.gz,"Klebsiella oxytoca strain 2024EL-00130 NODE_10_length_182246_cov_66.194697, whole genome shotgun sequence",0,All rRNA sequences shorter than 1400 bases,0,0
GCF_039571305.1_ASM3957130v1_genomic.gbff.gz,"Klebsiella michiganensis strain CDS8806 CDS8806_1, whole genome shotgun sequence",1,,1,0,1
GCF_039571325.1_ASM3957132v1_genomic.gbff.gz,"Klebsiella oxytoca strain CDS8301 CDS8301_1, whole genome shotgun sequence",0,All rRNA sequences shorter than 1400 bases,0,0
GCF_039571335.1_ASM3957133v1_genomic.gbff.gz,"Klebsiella michiganensis strain CDS8402 CDS8402_1, whole genome shotgun sequence",0,All rRNA sequences shorter than 1400 bases,0,0
GCF_039571365.1_ASM3957136v1_genomic.gbff.gz,"Klebsiella michiganensis strain CDS2301 CDS2301_1, whole genome shotgun sequence",1,,1,0,1
GCF_039571385.1_ASM3957138v1_genomic.gbff.gz,"Klebsiella michiganensis strain CDS1701 CDS1701_1, whole genome shotgun sequence",1,,1,0,1
GCF_039571405.1_ASM3957140v1_genomic.gbff.gz,"Klebsiella michiganensis strain CDS0801 CDS0801_1, whole genome shotgun sequence",1,,1,0,1
GCF_039571425.1_ASM3957142v1_genomic.gbff.gz,"Klebsiella michiganensis strain CDS0204 CDS0204_1, whole genome shotgun sequence",1,,1,0,1
GCF_039571445.1_ASM3957144v1_genomic.gbff.gz,"Klebsiella oxytoca strain CDS0301 CDS0301_1, whole genome shotgun sequence",1,,1,0,1
GCF_039571465.1_ASM3957146v1_genomic.gbff.gz,"Klebsiella michiganensis strain CDS0202 CDS0202_1, whole genome shotgun sequence",1,,1,0,1
GCF_039605015.1_ASM3960501v2_genomic.gbff.gz,"Klebsiella oxytoca strain 2024CK-00609 chromosome, complete genome",8,,8,0,1
GCF_039631385.1_ASM3963138v1_genomic.gbff.gz,"Klebsiella michiganensis strain 2024EL-00141 NODE_100_length_537_cov_34.417073, whole genome shotgun sequence",0,All rRNA sequences shorter than 1400 bases,0,0
GCF_040097165.1_ASM4009716v1_genomic.gbff.gz,"Klebsiella oxytoca strain CLA-MB-H007 CLA-MB-H007_contig_1_length_542325, whole genome shotgun sequence",1,,1,0,1
GCF_040137155.1_ASM4013715v1_genomic.gbff.gz,"Klebsiella michiganensis strain fly-1174 NODE_108_length_677_cov_1.918333, whole genome shotgun sequence",1,,1,0,1
GCF_040137435.1_ASM4013743v1_genomic.gbff.gz,"Klebsiella oxytoca strain fly-1157 NODE_103_length_568_cov_554.319756, whole genome shotgun sequence",1,,1,0,1
GCF_040138355.1_ASM4013835v1_genomic.gbff.gz,"Klebsiella michiganensis strain fly-1139 NODE_100_length_7969_cov_253.785606, whole genome shotgun sequence",1,,1,0,1
GCF_040138485.1_ASM4013848v1_genomic.gbff.gz,"Klebsiella oxytoca strain fly-1123 NODE_10_length_184417_cov_107.945492, whole genome shotgun sequence",0,All rRNA sequences shorter than 1400 bases,0,0
GCF_040138515.1_ASM4013851v1_genomic.gbff.gz,"Klebsiella oxytoca strain fly-1125 NODE_10_length_221233_cov_100.618581, whole genome shotgun sequence",1,,1,0,1
GCF_040138595.1_ASM4013859v1_genomic.gbff.gz,"Klebsiella oxytoca strain fly-1118 NODE_10_length_167887_cov_89.757827, whole genome shotgun sequence",1,,1,0,1
GCF_040138605.1_ASM4013860v1_genomic.gbff.gz,"Klebsiella oxytoca strain fly-1115 NODE_10_length_191603_cov_104.533740, whole genome shotgun sequence",1,,1,0,1
GCF_040138705.1_ASM4013870v1_genomic.gbff.gz,"Klebsiella oxytoca strain fly-1110 NODE_10_length_167887_cov_89.059627, whole genome shotgun sequence",1,,1,0,1
GCF_040139465.1_ASM4013946v1_genomic.gbff.gz,"Klebsiella michiganensis strain fly-1061 NODE_1_length_741365_cov_86.332197, whole genome shotgun sequence",0,No matching 16S rRNA product criteria,0,0
GCF_040139705.1_ASM4013970v1_genomic.gbff.gz,"Klebsiella pasteurii strain fly-1048 NODE_1_length_620331_cov_72.713506, whole genome shotgun sequence",1,,1,0,1
GCF_040215115.1_ASM4021511v1_genomic.gbff.gz,"Klebsiella michiganensis strain K2405 chromosome, complete genome",8,,2,6,2
GCF_040267715.1_ASM4026771v1_genomic.gbff.gz,"Klebsiella oxytoca strain KN chromosome, complete genome",8,,8,0,1
GCF_040270285.1_ASM4027028v1_genomic.gbff.gz,"Klebsiella grimontii strain KP001-TF60 1, whole genome shotgun sequence",1,,1,0,1
GCF_040558955.1_ASM4055895v1_genomic.gbff.gz,"Klebsiella michiganensis strain ST324KM1 NR5633_1, whole genome shotgun sequence",8,,5,3,1
GCF_040561235.1_ASM4056123v1_genomic.gbff.gz,"Klebsiella oxytoca strain ST30KO2 NR4938_1, whole genome shotgun sequence",8,,8,0,2
GCF_040561405.1_ASM4056140v1_genomic.gbff.gz,"Klebsiella michiganensis strain ST363KM2 NR4689_1, whole genome shotgun sequence",8,,8,0,1
GCF_040561445.1_ASM4056144v1_genomic.gbff.gz,"Klebsiella oxytoca strain ST106KO11 NR4686_1, whole genome shotgun sequence",8,,7,1,2
GCF_040563745.1_ASM4056374v1_genomic.gbff.gz,"Klebsiella michiganensis strain ST50KM1 NR0916_1, whole genome shotgun sequence",8,,8,0,1
GCF_040564465.1_ASM4056446v1_genomic.gbff.gz,"Klebsiella oxytoca strain ST176KO1 NR0072_1, whole genome shotgun sequence",8,,8,0,3
GCF_040565235.1_ASM4056523v1_genomic.gbff.gz,"Klebsiella oxytoca strain ST30KO1 KP0552_1, whole genome shotgun sequence",8,,7,1,1
GCF_040565895.1_ASM4056589v1_genomic.gbff.gz,"Klebsiella michiganensis strain ST167KM1 NR8124_1, whole genome shotgun sequence",8,,8,0,1
GCF_040566355.1_ASM4056635v1_genomic.gbff.gz,"Klebsiella michiganensis strain ST43KM1 NR6500_1, whole genome shotgun sequence",8,,8,0,2
GCF_040566915.1_ASM4056691v1_genomic.gbff.gz,"Klebsiella oxytoca strain ST30KO3 NR5770_1, whole genome shotgun sequence",8,,8,0,2
GCF_040571345.1_MRSN895358_genomic.gbff.gz,"Klebsiella michiganensis strain 895358 chromosome, complete genome",8,,5,3,2
GCF_040741945.1_ASM4074194v1_genomic.gbff.gz,"Klebsiella michiganensis strain KM3809_2019 1, whole genome shotgun sequence",0,All rRNA sequences shorter than 1400 bases,0,0
GCF_040742065.1_ASM4074206v1_genomic.gbff.gz,"Klebsiella oxytoca strain KO1765_2016 1, whole genome shotgun sequence",0,All rRNA sequences shorter than 1400 bases,0,0
GCF_040742085.1_ASM4074208v1_genomic.gbff.gz,"Klebsiella michiganensis strain KO916_2009 1, whole genome shotgun sequence",0,All rRNA sequences shorter than 1400 bases,0,0
GCF_040742135.1_ASM4074213v1_genomic.gbff.gz,"Klebsiella michiganensis strain KM860_2016 1, whole genome shotgun sequence",0,All rRNA sequences shorter than 1400 bases,0,0
GCF_040794845.1_ASM4079484v1_genomic.gbff.gz,"Klebsiella michiganensis strain KM-405983 scaffold1, whole genome shotgun sequence",1,,1,0,1
GCF_040797325.1_ASM4079732v1_genomic.gbff.gz,"Klebsiella michiganensis strain LACPHL-BACT-2024-00207 contig00001, whole genome shotgun sequence",0,No matching 16S rRNA product criteria,0,0
GCF_040838935.1_ASM4083893v1_genomic.gbff.gz,"Klebsiella grimontii strain 93 NODE_1, whole genome shotgun sequence",1,,1,0,1
GCF_040984225.1_ASM4098422v1_genomic.gbff.gz,"Klebsiella michiganensis strain H5 NODE_1_length_451573_cov_9.716845, whole genome shotgun sequence",0,All rRNA sequences shorter than 1400 bases,0,0
GCF_041003725.1_W257_genomic.gbff.gz,"Klebsiella pasteurii strain W257 chromosome, complete genome",8,,8,0,1
GCF_041003735.1_W255_genomic.gbff.gz,"Klebsiella pasteurii strain W255 chromosome, complete genome",8,,5,3,1
GCF_041202595.1_ASM4120259v1_genomic.gbff.gz,"Klebsiella oxytoca strain 297D6 ctg_1, whole genome shotgun sequence",0,All rRNA sequences shorter than 1400 bases,0,0
GCF_041226105.1_ASM4122610v1_genomic.gbff.gz,"Klebsiella pasteurii strain 5-274 voucher GPTB0032 scaffold1, whole genome shotgun sequence",1,,1,0,1
GCF_041227195.1_ASM4122719v1_genomic.gbff.gz,"Klebsiella michiganensis strain SXY-KO NODE_1_length_188674_cov_97.715393, whole genome shotgun sequence",0,All rRNA sequences shorter than 1400 bases,0,0
GCF_041282745.1_ASM4128274v1_genomic.gbff.gz,"Klebsiella michiganensis strain 2021CK-01841 chromosome, complete genome",8,,8,0,2
GCF_041283355.1_ASM4128335v1_genomic.gbff.gz,"Klebsiella michiganensis strain 2022CK-00199 chromosome, complete genome",8,,7,1,3
GCF_041283395.1_ASM4128339v1_genomic.gbff.gz,"Klebsiella michiganensis strain 2022CK-00289 chromosome, complete genome",8,,8,0,2
GCF_041283405.1_ASM4128340v1_genomic.gbff.gz,"Klebsiella michiganensis strain 2022CK-00479 chromosome, complete genome",8,,7,1,3
GCF_041283475.1_ASM4128347v1_genomic.gbff.gz,"Klebsiella pasteurii strain 2023CK-01306 chromosome, complete genome",8,,8,0,2
GCF_041283485.1_ASM4128348v1_genomic.gbff.gz,"Klebsiella michiganensis strain 2022CK-00623 chromosome, complete genome",8,,7,1,2
GCF_041283495.1_ASM4128349v1_genomic.gbff.gz,"Klebsiella michiganensis strain 2023CK-00457 chromosome, complete genome",8,,4,4,1
GCF_041353115.1_ASM4135311v1_genomic.gbff.gz,"Klebsiella oxytoca strain F05 NODE_1_length_387460_cov_88.050552, whole genome shotgun sequence",0,All rRNA sequences shorter than 1400 bases,0,0
GCF_041698715.1_ASM4169871v1_genomic.gbff.gz,"Klebsiella oxytoca strain Kox-70 voucher CIFTWPfiveKO9 NODE_10_length_231100_cov_14.000996, whole genome shotgun sequence",0,All rRNA sequences shorter than 1400 bases,0,0
GCF_041699445.1_ASM4169944v1_genomic.gbff.gz,"Klebsiella oxytoca strain Kox-77 voucher CIFTWPfiveKO16 NODE_100_length_237_cov_53.045455, whole genome shotgun sequence",0,All rRNA sequences shorter than 1400 bases,0,0
GCF_041699465.1_ASM4169946v1_genomic.gbff.gz,"Klebsiella oxytoca strain Kox-78 voucher CIFTWPfiveKO17 NODE_100_length_255_cov_65.937500, whole genome shotgun sequence",1,,1,0,1
GCF_042137955.1_sbm_k_oxy_1_genomic.gbff.gz,"Klebsiella oxytoca strain 3238 chromosome, complete genome",8,,8,0,1
GCF_042137965.1_sbm_k_grim_1_genomic.gbff.gz,"Klebsiella grimontii strain 2750 chromosome, complete genome",8,,8,0,1
GCF_042274125.1_ASM4227412v1_genomic.gbff.gz,"Klebsiella michiganensis strain a14 Contig_000001, whole genome shotgun sequence",1,,1,0,1
GCF_900083565.1_12082_4_84_genomic.gbff.gz,"Klebsiella michiganensis strain 2880STDY5682563, whole genome shotgun sequence",1,,1,0,1
GCF_900083575.1_12045_6_1_genomic.gbff.gz,"Klebsiella michiganensis strain 2880STDY5682446, whole genome shotgun sequence",1,,1,0,1
GCF_900083585.1_12045_6_24_genomic.gbff.gz,"Klebsiella oxytoca strain 2880STDY5682471, whole genome shotgun sequence",1,,1,0,1
GCF_900083595.1_12045_6_57_genomic.gbff.gz,"Klebsiella grimontii strain 2880STDY5682505, whole genome shotgun sequence",0,All rRNA sequences shorter than 1400 bases,0,0
GCF_900083605.1_11983_8_48_genomic.gbff.gz,"Klebsiella grimontii strain 2880STDY5682622, whole genome shotgun sequence",1,,1,0,1
GCF_900083615.1_11983_8_91_genomic.gbff.gz,"Klebsiella oxytoca strain 2880STDY5682683, whole genome shotgun sequence",1,,1,0,1
GCF_900083625.1_11983_8_83_genomic.gbff.gz,"Klebsiella oxytoca strain 2880STDY5682672, whole genome shotgun sequence",1,,1,0,1
GCF_900083635.1_12082_2_19_genomic.gbff.gz,"Klebsiella michiganensis strain 2880STDY5682809, whole genome shotgun sequence",1,,1,0,1
GCF_900083645.1_12082_5_20_genomic.gbff.gz,"Klebsiella oxytoca strain 2880STDY5682681, whole genome shotgun sequence",1,,1,0,1
GCF_900083655.1_11983_8_52_genomic.gbff.gz,"Klebsiella oxytoca strain 2880STDY5682626, whole genome shotgun sequence",1,,1,0,1
GCF_900083675.1_12045_6_65_genomic.gbff.gz,"Klebsiella oxytoca strain 2880STDY5682516, whole genome shotgun sequence",1,,1,0,1
GCF_900083695.1_12045_6_61_genomic.gbff.gz,"Klebsiella michiganensis strain 2880STDY5682512, whole genome shotgun sequence",1,,1,0,1
GCF_900083705.1_12045_6_72_genomic.gbff.gz,"Klebsiella oxytoca strain 2880STDY5682532, whole genome shotgun sequence",1,,1,0,1
GCF_900083715.1_12045_6_80_genomic.gbff.gz,"Klebsiella oxytoca strain 2880STDY5682541, whole genome shotgun sequence",1,,1,0,1
GCF_900083725.1_12045_6_46_genomic.gbff.gz,"Klebsiella oxytoca strain 2880STDY5682493, whole genome shotgun sequence",1,,1,0,1
GCF_900083735.1_12045_5_89_genomic.gbff.gz,"Klebsiella oxytoca strain 2880STDY5682436, whole genome shotgun sequence",1,,1,0,1
GCF_900083745.1_11983_8_86_genomic.gbff.gz,"Klebsiella oxytoca strain 2880STDY5682675, whole genome shotgun sequence",1,,1,0,1
GCF_900083765.1_12045_6_56_genomic.gbff.gz,"Klebsiella oxytoca strain 2880STDY5682504, whole genome shotgun sequence",1,,1,0,1
GCF_900083785.1_12045_6_48_genomic.gbff.gz,"Klebsiella oxytoca strain 2880STDY5682495, whole genome shotgun sequence",1,,1,0,1
GCF_900083795.1_12045_7_49_genomic.gbff.gz,"Klebsiella oxytoca strain 2880STDY5682743, whole genome shotgun sequence",1,,1,0,1
GCF_900083805.1_11983_8_73_genomic.gbff.gz,"Klebsiella michiganensis strain 2880STDY5682653, whole genome shotgun sequence",1,,1,0,1
GCF_900083815.1_11983_8_93_genomic.gbff.gz,"Klebsiella oxytoca strain 2880STDY5682686, whole genome shotgun sequence",1,,1,0,1
GCF_900083825.1_11983_8_7_genomic.gbff.gz,"Klebsiella michiganensis strain 2880STDY5682571, whole genome shotgun sequence",1,,1,0,1
GCF_900083835.1_12045_7_3_genomic.gbff.gz,"Klebsiella michiganensis strain 2880STDY5682693, whole genome shotgun sequence",1,,1,0,1
GCF_900083855.1_12045_6_35_genomic.gbff.gz,"Klebsiella oxytoca strain 2880STDY5682482, whole genome shotgun sequence",1,,1,0,1
GCF_900083865.1_12082_4_71_genomic.gbff.gz,"Klebsiella oxytoca strain 2880STDY5682456, whole genome shotgun sequence",1,,1,0,1
GCF_900083875.1_11983_8_42_genomic.gbff.gz,"Klebsiella oxytoca strain 2880STDY5682611, whole genome shotgun sequence",1,,1,0,1
GCF_900083885.1_12045_6_23_genomic.gbff.gz,"Klebsiella michiganensis strain 2880STDY5682470, whole genome shotgun sequence",1,,1,0,1
GCF_900083895.1_12045_6_44_genomic.gbff.gz,"Klebsiella oxytoca strain 2880STDY5682490, whole genome shotgun sequence",1,,1,0,1
GCF_900083905.1_12045_5_88_genomic.gbff.gz,"Klebsiella oxytoca strain 2880STDY5682435, whole genome shotgun sequence",1,,1,0,1
GCF_900083915.1_11983_8_30_genomic.gbff.gz,"Klebsiella michiganensis strain 2880STDY5682598, whole genome shotgun sequence",1,,1,0,1
GCF_900083945.1_12045_6_10_genomic.gbff.gz,"Klebsiella oxytoca strain 2880STDY5682455, whole genome shotgun sequence",1,,1,0,1
GCF_900083955.1_12045_7_17_genomic.gbff.gz,"Klebsiella oxytoca strain 2880STDY5682710, whole genome shotgun sequence",1,,1,0,1
GCF_900083965.1_12045_6_81_genomic.gbff.gz,"Klebsiella oxytoca strain 2880STDY5682542, whole genome shotgun sequence",1,,1,0,1
GCF_900083975.1_12045_6_58_genomic.gbff.gz,"Klebsiella oxytoca strain 2880STDY5682506, whole genome shotgun sequence",1,,1,0,1
GCF_900083985.1_12045_6_90_genomic.gbff.gz,"Klebsiella oxytoca strain 2880STDY5682554, whole genome shotgun sequence",1,,1,0,1
GCF_900083995.1_12045_6_74_genomic.gbff.gz,"Klebsiella oxytoca strain 2880STDY5682534, whole genome shotgun sequence",1,,1,0,1
GCF_900084015.1_12082_2_4_genomic.gbff.gz,"Klebsiella oxytoca strain 2880STDY5682795, whole genome shotgun sequence",1,,1,0,1
GCF_900084025.1_11983_8_41_genomic.gbff.gz,"Klebsiella oxytoca strain 2880STDY5682610, whole genome shotgun sequence",0,All rRNA sequences shorter than 1400 bases,0,0
GCF_900084035.1_12082_5_21_genomic.gbff.gz,"Klebsiella michiganensis strain 2880STDY5682685, whole genome shotgun sequence",1,,1,0,1
GCF_900084045.1_12082_5_29_genomic.gbff.gz,"Klebsiella oxytoca strain 2880STDY5682786, whole genome shotgun sequence",1,,1,0,1
GCF_900200035.1_ASM90020003v1_genomic.gbff.gz,"Klebsiella grimontii strain 06D021, whole genome shotgun sequence",1,,1,0,1
GCF_900407115.1_De_novo_assembly_of_KCRI_isolate_R0004_259C_genomic.gbff.gz,"Klebsiella oxytoca strain KCRI-259C isolate R0004_259C, whole genome shotgun sequence",0,All rRNA sequences shorter than 1400 bases,0,0
GCF_900407165.1_De_novo_assembly_of_KCRI_isolate_RDK37_40_genomic.gbff.gz,"Klebsiella michiganensis strain KCRI-40 isolate RDK37_40, whole genome shotgun sequence",1,,1,0,1
GCF_900407255.1_De_novo_assembly_of_KCRI_isolate_R0009_567C_genomic.gbff.gz,"Klebsiella michiganensis strain KCRI-567C isolate R0009_567C, whole genome shotgun sequence",0,All rRNA sequences shorter than 1400 bases,0,0
GCF_900451165.1_44787_G01_genomic.gbff.gz,"Klebsiella oxytoca strain NCTC13775, whole genome shotgun sequence",8,,6,2,2
GCF_900451235.1_36340_F02_genomic.gbff.gz,"Klebsiella oxytoca strain NCTC11691, whole genome shotgun sequence",8,,5,3,2
GCF_900451255.1_32473_E02_genomic.gbff.gz,"Klebsiella oxytoca strain NCTC11696, whole genome shotgun sequence",8,,8,0,5
GCF_900478285.1_36005_G01_genomic.gbff.gz,"Klebsiella oxytoca strain NCTC11355 genome assembly, chromosome: 1",8,,5,3,2
GCF_900635105.1_36109_D01_genomic.gbff.gz,"Klebsiella oxytoca strain NCTC11356 chromosome 1, complete sequence",8,,5,3,2
GCF_900636985.1_45889_C01_genomic.gbff.gz,"Klebsiella oxytoca strain NCTC13727 chromosome 1, complete sequence",8,,4,4,1
GCF_900977765.1_ATCC13182.1_genomic.gbff.gz,"Klebsiella oxytoca isolate rATCC13182, whole genome shotgun sequence",0,All rRNA sequences shorter than 1400 bases,0,0
GCF_901212425.1_NZ_Klebsiella_oxytoca_MC1_genomic.gbff.gz,"Klebsiella oxytoca isolate Klebsiella_oxytoca_MC1, whole genome shotgun sequence",1,,1,0,1
GCF_901542455.1_40345_E01_genomic.gbff.gz,Klebsiella grimontii strain NCTC9146 substr. serovar casular type 26 substr. serovar casular type 26 chromosome 1,8,,5,3,2
GCF_901553745.1_SB9_16A079_Ko1_genomic.gbff.gz,"Klebsiella michiganensis isolate SB9, whole genome shotgun sequence",1,,1,0,1
GCF_901556995.1_SB4934_W14T_Ko1_genomic.gbff.gz,"Klebsiella michiganensis isolate SB4934, whole genome shotgun sequence",8,,6,2,3
GCF_901563825.1_SB3355_SG266_Ko4_genomic.gbff.gz,"Klebsiella pasteurii isolate SB3355, whole genome shotgun sequence",1,,1,0,1
GCF_901563875.1_SB3356_SG271_Ko3_genomic.gbff.gz,"Klebsiella spallanzanii isolate SB3356, whole genome shotgun sequence",0,All rRNA sequences shorter than 1400 bases,0,0
GCF_901563895.1_SB2908_10A188_Ko1_genomic.gbff.gz,"Klebsiella michiganensis isolate SB2908, whole genome shotgun sequence",1,,1,0,1
GCF_902158545.1_SB6410_genomic.gbff.gz,"Klebsiella pasteurii isolate SB6410, whole genome shotgun sequence",1,,1,0,1
GCF_902158555.1_SB6411_genomic.gbff.gz,"Klebsiella spallanzanii isolate SB6411, whole genome shotgun sequence",1,,1,0,1
GCF_902158565.1_SB6419_genomic.gbff.gz,"Klebsiella spallanzanii isolate SB6419, whole genome shotgun sequence",0,All rRNA sequences shorter than 1400 bases,0,0
GCF_902158575.1_SB6409_genomic.gbff.gz,"Klebsiella pasteurii isolate SB6409, whole genome shotgun sequence",1,,1,0,1
GCF_902158585.1_SB6407_genomic.gbff.gz,"Klebsiella pasteurii isolate SB6407, whole genome shotgun sequence",1,,1,0,1
GCF_902158595.1_SB6408_genomic.gbff.gz,"Klebsiella spallanzanii isolate SB6408, whole genome shotgun sequence",1,,1,0,1
GCF_902158605.1_SB6422_genomic.gbff.gz,"Klebsiella huaxiensis isolate SB6422, whole genome shotgun sequence",1,,1,0,1
GCF_902158625.1_SB6421_genomic.gbff.gz,"Klebsiella huaxiensis isolate SB6421, whole genome shotgun sequence",1,,1,0,1
GCF_902158635.1_SB6415_genomic.gbff.gz,"Klebsiella pasteurii isolate SB6415, whole genome shotgun sequence",1,,1,0,1
GCF_902158645.1_SB6420_genomic.gbff.gz,"Klebsiella pasteurii isolate SB6420, whole genome shotgun sequence",1,,1,0,1
GCF_902158655.1_SB6414_genomic.gbff.gz,"Klebsiella pasteurii isolate SB6414, whole genome shotgun sequence",1,,1,0,1
GCF_902158665.1_SB6416_genomic.gbff.gz,"Klebsiella pasteurii isolate SB6416, whole genome shotgun sequence",1,,1,0,1
GCF_902158685.1_SB6424_genomic.gbff.gz,"Klebsiella pasteurii isolate SB6424, whole genome shotgun sequence",1,,1,0,1
GCF_902158695.1_SB6417_genomic.gbff.gz,"Klebsiella pasteurii isolate SB6417, whole genome shotgun sequence",1,,1,0,1
GCF_902158705.1_SB6423_genomic.gbff.gz,"Klebsiella pasteurii isolate SB6423, whole genome shotgun sequence",1,,1,0,1
GCF_902158715.1_SB6413_genomic.gbff.gz,"Klebsiella pasteurii isolate SB6413, whole genome shotgun sequence",1,,1,0,1
GCF_902158725.1_SB6412_genomic.gbff.gz,"Klebsiella pasteurii isolate SB6412, whole genome shotgun sequence",1,,1,0,1
GCF_902158835.1_25426_7_11_genomic.gbff.gz,"Klebsiella oxytoca strain 4928STDY7071294, whole genome shotgun sequence",1,,1,0,1
GCF_902158845.1_25426_7_19_genomic.gbff.gz,"Klebsiella michiganensis strain 4928STDY7071315, whole genome shotgun sequence",0,All rRNA sequences shorter than 1400 bases,0,0
GCF_902158915.1_25426_7_15_genomic.gbff.gz,"Klebsiella michiganensis strain 4928STDY7071300, whole genome shotgun sequence",1,,1,0,1
GCF_902159075.1_25426_7_27_genomic.gbff.gz,"Klebsiella michiganensis strain 4928STDY7071335, whole genome shotgun sequence",1,,1,0,1
GCF_902159485.1_25426_7_80_genomic.gbff.gz,"Klebsiella grimontii strain 4928STDY7071291, whole genome shotgun sequence",1,,1,0,1
GCF_902159515.1_25426_7_77_genomic.gbff.gz,"Klebsiella michiganensis strain 4928STDY7071654, whole genome shotgun sequence",1,,1,0,1
GCF_902159535.1_25426_7_89_genomic.gbff.gz,"Klebsiella michiganensis strain 4928STDY7071306, whole genome shotgun sequence",1,,1,0,1
GCF_902159585.1_25426_7_84_genomic.gbff.gz,"Klebsiella grimontii strain 4928STDY7071299, whole genome shotgun sequence",1,,1,0,1
GCF_902159595.1_25426_7_91_genomic.gbff.gz,"Klebsiella grimontii strain 4928STDY7071309, whole genome shotgun sequence",1,,1,0,1
GCF_902159605.1_25426_7_82_genomic.gbff.gz,"Klebsiella oxytoca strain 4928STDY7071293, whole genome shotgun sequence",1,,1,0,1
GCF_902159625.1_25426_7_83_genomic.gbff.gz,"Klebsiella grimontii strain 4928STDY7071297, whole genome shotgun sequence",1,,1,0,1
GCF_902159665.1_25426_7_100_genomic.gbff.gz,"Klebsiella grimontii strain 4928STDY7071327, whole genome shotgun sequence",1,,1,0,1
GCF_902159715.1_25426_7_95_genomic.gbff.gz,"Klebsiella grimontii strain 4928STDY7071314, whole genome shotgun sequence",1,,1,0,1
GCF_902159745.1_25426_7_106_genomic.gbff.gz,"Klebsiella michiganensis strain 4928STDY7071333, whole genome shotgun sequence",1,,1,0,1
GCF_902159765.1_25426_7_105_genomic.gbff.gz,"Klebsiella michiganensis strain 4928STDY7071332, whole genome shotgun sequence",1,,1,0,1
GCF_902159775.1_25426_7_111_genomic.gbff.gz,"Klebsiella michiganensis strain 4928STDY7071339, whole genome shotgun sequence",1,,1,0,1
GCF_902159785.1_25426_7_115_genomic.gbff.gz,"Klebsiella oxytoca strain 4928STDY7071345, whole genome shotgun sequence",1,,1,0,1
GCF_902159795.1_25426_7_107_genomic.gbff.gz,"Klebsiella michiganensis strain 4928STDY7071334, whole genome shotgun sequence",1,,1,0,1
GCF_902159805.1_25426_7_104_genomic.gbff.gz,"Klebsiella michiganensis strain 4928STDY7071331, whole genome shotgun sequence",1,,1,0,1
GCF_902159815.1_25426_7_109_genomic.gbff.gz,"Klebsiella michiganensis strain 4928STDY7071337, whole genome shotgun sequence",1,,1,0,1
GCF_902159865.1_25426_7_125_genomic.gbff.gz,"Klebsiella michiganensis strain 4928STDY7071363, whole genome shotgun sequence",1,,1,0,1
GCF_902159905.1_25426_7_124_genomic.gbff.gz,"Klebsiella michiganensis strain 4928STDY7071362, whole genome shotgun sequence",1,,1,0,1
GCF_902160175.1_25426_7_158_genomic.gbff.gz,"Klebsiella grimontii strain 4928STDY7071405, whole genome shotgun sequence",1,,1,0,1
GCF_902160195.1_25426_7_156_genomic.gbff.gz,"Klebsiella grimontii strain 4928STDY7071403, whole genome shotgun sequence",1,,1,0,1
GCF_902160215.1_25426_7_154_genomic.gbff.gz,"Klebsiella grimontii strain 4928STDY7071401, whole genome shotgun sequence",1,,1,0,1
GCF_902160225.1_25426_7_157_genomic.gbff.gz,"Klebsiella grimontii strain 4928STDY7071404, whole genome shotgun sequence",1,,1,0,1
GCF_902160245.1_25426_7_159_genomic.gbff.gz,"Klebsiella grimontii strain 4928STDY7071406, whole genome shotgun sequence",0,All rRNA sequences shorter than 1400 bases,0,0
GCF_902160265.1_25426_7_165_genomic.gbff.gz,"Klebsiella grimontii strain 4928STDY7071413, whole genome shotgun sequence",1,,1,0,1
GCF_902160275.1_25426_7_167_genomic.gbff.gz,"Klebsiella grimontii strain 4928STDY7071415, whole genome shotgun sequence",1,,1,0,1
GCF_902160315.1_25426_7_161_genomic.gbff.gz,"Klebsiella grimontii strain 4928STDY7071408, whole genome shotgun sequence",1,,1,0,1
GCF_902160335.1_25426_7_171_genomic.gbff.gz,"Klebsiella grimontii strain 4928STDY7071420, whole genome shotgun sequence",1,,1,0,1
GCF_902160345.1_25426_7_176_genomic.gbff.gz,"Klebsiella grimontii strain 4928STDY7071425, whole genome shotgun sequence",1,,1,0,1
GCF_902160355.1_25426_7_172_genomic.gbff.gz,"Klebsiella grimontii strain 4928STDY7071421, whole genome shotgun sequence",1,,1,0,1
GCF_902160365.1_25426_7_173_genomic.gbff.gz,"Klebsiella grimontii strain 4928STDY7071422, whole genome shotgun sequence",1,,1,0,1
GCF_902160515.1_25426_7_183_genomic.gbff.gz,"Klebsiella grimontii strain 4928STDY7071433, whole genome shotgun sequence",1,,1,0,1
GCF_902160585.1_25426_7_195_genomic.gbff.gz,"Klebsiella grimontii strain 4928STDY7071448, whole genome shotgun sequence",1,,1,0,1
GCF_902160605.1_25426_7_196_genomic.gbff.gz,"Klebsiella grimontii strain 4928STDY7071449, whole genome shotgun sequence",0,All rRNA sequences shorter than 1400 bases,0,0
GCF_902160675.1_25426_7_211_genomic.gbff.gz,"Klebsiella grimontii strain 4928STDY7071470, whole genome shotgun sequence",1,,1,0,1
GCF_902160685.1_25426_7_209_genomic.gbff.gz,"Klebsiella michiganensis strain 4928STDY7071467, whole genome shotgun sequence",0,All rRNA sequences shorter than 1400 bases,0,0
GCF_902160725.1_25426_7_203_genomic.gbff.gz,"Klebsiella michiganensis strain 4928STDY7071458, whole genome shotgun sequence",1,,1,0,1
GCF_902160755.1_25426_7_205_genomic.gbff.gz,"Klebsiella grimontii strain 4928STDY7071460, whole genome shotgun sequence",1,,1,0,1
GCF_902160765.1_25426_7_217_genomic.gbff.gz,"Klebsiella oxytoca strain 4928STDY7071478, whole genome shotgun sequence",1,,1,0,1
GCF_902160775.1_25426_7_216_genomic.gbff.gz,"Klebsiella grimontii strain 4928STDY7071477, whole genome shotgun sequence",1,,1,0,1
GCF_902160845.1_25426_7_218_genomic.gbff.gz,"Klebsiella grimontii strain 4928STDY7071479, whole genome shotgun sequence",1,,1,0,1
GCF_902160885.1_25426_7_226_genomic.gbff.gz,"Klebsiella oxytoca strain 4928STDY7071488, whole genome shotgun sequence",0,All rRNA sequences shorter than 1400 bases,0,0
GCF_902160925.1_25426_7_228_genomic.gbff.gz,"Klebsiella oxytoca strain 4928STDY7071490, whole genome shotgun sequence",0,All rRNA sequences shorter than 1400 bases,0,0
GCF_902161015.1_25426_7_257_genomic.gbff.gz,"Klebsiella grimontii strain 4928STDY7071521, whole genome shotgun sequence",0,All rRNA sequences shorter than 1400 bases,0,0
GCF_902161025.1_25426_7_255_genomic.gbff.gz,"Klebsiella grimontii strain 4928STDY7071519, whole genome shotgun sequence",0,All rRNA sequences shorter than 1400 bases,0,0
GCF_902161065.1_25426_7_242_genomic.gbff.gz,"Klebsiella grimontii strain 4928STDY7071506, whole genome shotgun sequence",1,,1,0,1
GCF_902161135.1_25426_7_256_genomic.gbff.gz,"Klebsiella grimontii strain 4928STDY7071520, whole genome shotgun sequence",0,All rRNA sequences shorter than 1400 bases,0,0
GCF_902161195.1_25426_7_243_genomic.gbff.gz,"Klebsiella grimontii strain 4928STDY7071507, whole genome shotgun sequence",1,,1,0,1
GCF_902161205.1_25426_7_241_genomic.gbff.gz,"Klebsiella grimontii strain 4928STDY7071505, whole genome shotgun sequence",0,All rRNA sequences shorter than 1400 bases,0,0
GCF_902161235.1_25426_7_258_genomic.gbff.gz,"Klebsiella grimontii strain 4928STDY7071522, whole genome shotgun sequence",0,All rRNA sequences shorter than 1400 bases,0,0
GCF_902161245.1_25426_7_260_genomic.gbff.gz,"Klebsiella grimontii strain 4928STDY7071524, whole genome shotgun sequence",0,All rRNA sequences shorter than 1400 bases,0,0
GCF_902161285.1_25426_7_259_genomic.gbff.gz,"Klebsiella grimontii strain 4928STDY7071523, whole genome shotgun sequence",1,,1,0,1
GCF_902161405.1_25426_7_277_genomic.gbff.gz,"Klebsiella oxytoca strain 4928STDY7071547, whole genome shotgun sequence",1,,1,0,1
GCF_902161425.1_25426_7_286_genomic.gbff.gz,"Klebsiella grimontii strain 4928STDY7071557, whole genome shotgun sequence",0,All rRNA sequences shorter than 1400 bases,0,0
GCF_902161625.1_25426_7_294_genomic.gbff.gz,"Klebsiella grimontii strain 4928STDY7071567, whole genome shotgun sequence",1,,1,0,1
GCF_902161885.1_25426_7_333_genomic.gbff.gz,"Klebsiella michiganensis strain 4928STDY7071614, whole genome shotgun sequence",1,,1,0,1
GCF_902161925.1_25426_7_329_genomic.gbff.gz,"Klebsiella oxytoca strain 4928STDY7071610, whole genome shotgun sequence",0,All rRNA sequences shorter than 1400 bases,0,0
GCF_902161955.1_25426_7_332_genomic.gbff.gz,"Klebsiella michiganensis strain 4928STDY7071613, whole genome shotgun sequence",1,,1,0,1
GCF_902162205.1_25426_7_380_genomic.gbff.gz,"Klebsiella grimontii strain 4928STDY7071669, whole genome shotgun sequence",0,All rRNA sequences shorter than 1400 bases,0,0
GCF_902162255.1_25426_7_381_genomic.gbff.gz,"Klebsiella grimontii strain 4928STDY7071670, whole genome shotgun sequence",1,,1,0,1
GCF_902162325.1_25426_7_370_genomic.gbff.gz,"Klebsiella michiganensis strain 4928STDY7071657, whole genome shotgun sequence",1,,1,0,1
GCF_902162365.1_25426_7_382_genomic.gbff.gz,"Klebsiella michiganensis strain 4928STDY7071671, whole genome shotgun sequence",1,,1,0,1
GCF_902162375.1_25426_7_379_genomic.gbff.gz,"Klebsiella grimontii strain 4928STDY7071668, whole genome shotgun sequence",1,,1,0,1
GCF_902162385.1_25964_2_5_genomic.gbff.gz,"Klebsiella michiganensis strain 4928STDY7071118, whole genome shotgun sequence",1,,1,0,1
GCF_902162395.1_25964_2_15_genomic.gbff.gz,"Klebsiella michiganensis strain 4928STDY7071132, whole genome shotgun sequence",1,,1,0,1
GCF_902162405.1_25964_2_7_genomic.gbff.gz,"Klebsiella michiganensis strain 4928STDY7071120, whole genome shotgun sequence",0,All rRNA sequences shorter than 1400 bases,0,0
GCF_902162445.1_25964_2_8_genomic.gbff.gz,"Klebsiella michiganensis strain 4928STDY7071121, whole genome shotgun sequence",1,,1,0,1
GCF_902162465.1_25964_2_12_genomic.gbff.gz,"Klebsiella michiganensis strain 4928STDY7071129, whole genome shotgun sequence",1,,1,0,1
GCF_902162475.1_25964_2_6_genomic.gbff.gz,"Klebsiella michiganensis strain 4928STDY7071119, whole genome shotgun sequence",1,,1,0,1
GCF_902162505.1_25964_2_14_genomic.gbff.gz,"Klebsiella michiganensis strain 4928STDY7071131, whole genome shotgun sequence",1,,1,0,1
GCF_902162525.1_25964_2_13_genomic.gbff.gz,"Klebsiella michiganensis strain 4928STDY7071130, whole genome shotgun sequence",1,,1,0,1
GCF_902162565.1_25964_2_23_genomic.gbff.gz,"Klebsiella grimontii strain 4928STDY7071144, whole genome shotgun sequence",1,,1,0,1
GCF_902162595.1_25964_2_26_genomic.gbff.gz,"Klebsiella grimontii strain 4928STDY7071147, whole genome shotgun sequence",1,,1,0,1
GCF_902162635.1_25964_2_32_genomic.gbff.gz,"Klebsiella michiganensis strain 4928STDY7071157, whole genome shotgun sequence",1,,1,0,1
GCF_902162645.1_25964_2_41_genomic.gbff.gz,"Klebsiella michiganensis strain 4928STDY7071170, whole genome shotgun sequence",1,,1,0,1
GCF_902162685.1_25964_2_33_genomic.gbff.gz,"Klebsiella michiganensis strain 4928STDY7071158, whole genome shotgun sequence",0,All rRNA sequences shorter than 1400 bases,0,0
GCF_902162695.1_25964_2_29_genomic.gbff.gz,"Klebsiella grimontii strain 4928STDY7071153, whole genome shotgun sequence",1,,1,0,1
GCF_902162705.1_25964_2_34_genomic.gbff.gz,"Klebsiella michiganensis strain 4928STDY7071159, whole genome shotgun sequence",0,All rRNA sequences shorter than 1400 bases,0,0
GCF_902162725.1_25964_2_43_genomic.gbff.gz,"Klebsiella michiganensis strain 4928STDY7071172, whole genome shotgun sequence",1,,1,0,1
GCF_902162735.1_25964_2_47_genomic.gbff.gz,"Klebsiella michiganensis strain 4928STDY7071176, whole genome shotgun sequence",1,,1,0,1
GCF_902162745.1_25964_2_48_genomic.gbff.gz,"Klebsiella michiganensis strain 4928STDY7071177, whole genome shotgun sequence",1,,1,0,1
GCF_902162765.1_25964_2_46_genomic.gbff.gz,"Klebsiella grimontii strain 4928STDY7071175, whole genome shotgun sequence",1,,1,0,1
GCF_902162775.1_25964_2_49_genomic.gbff.gz,"Klebsiella michiganensis strain 4928STDY7071178, whole genome shotgun sequence",1,,1,0,1
GCF_902162835.1_25964_2_58_genomic.gbff.gz,"Klebsiella grimontii strain 4928STDY7071192, whole genome shotgun sequence",1,,1,0,1
GCF_902162845.1_25964_2_52_genomic.gbff.gz,"Klebsiella grimontii strain 4928STDY7071182, whole genome shotgun sequence",1,,1,0,1
GCF_902162875.1_25964_2_51_genomic.gbff.gz,"Klebsiella oxytoca strain 4928STDY7071180, whole genome shotgun sequence",0,All rRNA sequences shorter than 1400 bases,0,0
GCF_902162905.1_25964_2_59_genomic.gbff.gz,"Klebsiella oxytoca strain 4928STDY7071193, whole genome shotgun sequence",0,All rRNA sequences shorter than 1400 bases,0,0
GCF_902162915.1_25964_2_53_genomic.gbff.gz,"Klebsiella grimontii strain 4928STDY7071184, whole genome shotgun sequence",1,,1,0,1
GCF_902163185.1_25964_2_102_genomic.gbff.gz,"Klebsiella grimontii strain 4928STDY7071683, whole genome shotgun sequence",1,,1,0,1
GCF_902163205.1_25964_2_97_genomic.gbff.gz,"Klebsiella michiganensis strain 4928STDY7071678, whole genome shotgun sequence",1,,1,0,1
GCF_902163215.1_25964_2_96_genomic.gbff.gz,"Klebsiella michiganensis strain 4928STDY7071677, whole genome shotgun sequence",1,,1,0,1
GCF_902163225.1_25964_2_98_genomic.gbff.gz,"Klebsiella michiganensis strain 4928STDY7071679, whole genome shotgun sequence",1,,1,0,1
GCF_902163235.1_25964_2_101_genomic.gbff.gz,"Klebsiella michiganensis strain 4928STDY7071682, whole genome shotgun sequence",1,,1,0,1
GCF_902163375.1_25964_2_120_genomic.gbff.gz,"Klebsiella oxytoca strain 4928STDY7071701, whole genome shotgun sequence",0,All rRNA sequences shorter than 1400 bases,0,0
GCF_902163385.1_25964_2_125_genomic.gbff.gz,"Klebsiella michiganensis strain 4928STDY7071706, whole genome shotgun sequence",1,,1,0,1
GCF_902163395.1_25964_2_128_genomic.gbff.gz,"Klebsiella michiganensis strain 4928STDY7071709, whole genome shotgun sequence",1,,1,0,1
GCF_902163545.1_25964_2_133_genomic.gbff.gz,"Klebsiella oxytoca strain 4928STDY7071714, whole genome shotgun sequence",1,,1,0,1
GCF_902164055.1_25964_2_199_genomic.gbff.gz,"Klebsiella grimontii strain 4928STDY7387683, whole genome shotgun sequence",0,All rRNA sequences shorter than 1400 bases,0,0
GCF_902164065.1_25964_2_198_genomic.gbff.gz,"Klebsiella grimontii strain 4928STDY7387682, whole genome shotgun sequence",1,,1,0,1
GCF_902164135.1_25964_2_207_genomic.gbff.gz,"Klebsiella grimontii strain 4928STDY7387691, whole genome shotgun sequence",0,All rRNA sequences shorter than 1400 bases,0,0
GCF_902164155.1_25964_2_200_genomic.gbff.gz,"Klebsiella grimontii strain 4928STDY7387684, whole genome shotgun sequence",1,,1,0,1
GCF_902164185.1_25964_2_206_genomic.gbff.gz,"Klebsiella grimontii strain 4928STDY7387690, whole genome shotgun sequence",1,,1,0,1
GCF_902164205.1_25964_2_201_genomic.gbff.gz,"Klebsiella grimontii strain 4928STDY7387685, whole genome shotgun sequence",1,,1,0,1
GCF_902164285.1_25964_2_210_genomic.gbff.gz,"Klebsiella oxytoca strain 4928STDY7387694, whole genome shotgun sequence",1,,1,0,1
GCF_902164365.1_25964_2_229_genomic.gbff.gz,"Klebsiella michiganensis strain 4928STDY7387714, whole genome shotgun sequence",1,,1,0,1
GCF_902164595.1_25964_2_255_genomic.gbff.gz,"Klebsiella michiganensis strain 4928STDY7387741, whole genome shotgun sequence",0,All rRNA sequences shorter than 1400 bases,0,0
GCF_902164605.1_25964_2_256_genomic.gbff.gz,"Klebsiella michiganensis strain 4928STDY7387742, whole genome shotgun sequence",1,,1,0,1
GCF_902164635.1_25426_7_81_genomic.gbff.gz,Klebsiella michiganensis strain 4928STDY7071292 chromosome 1,1,,1,0,1
GCF_902164675.1_25426_7_101_genomic.gbff.gz,Klebsiella grimontii strain 4928STDY7071328 chromosome 1,1,,1,0,1
GCF_902164825.1_25964_2_259_genomic.gbff.gz,"Klebsiella oxytoca strain 4928STDY7387745, whole genome shotgun sequence",1,,1,0,1
GCF_902164835.1_25964_2_271_genomic.gbff.gz,"Klebsiella michiganensis strain 4928STDY7387757, whole genome shotgun sequence",1,,1,0,1
GCF_902164895.1_25964_2_268_genomic.gbff.gz,"Klebsiella grimontii strain 4928STDY7387754, whole genome shotgun sequence",1,,1,0,1
GCF_902164905.1_25964_2_261_genomic.gbff.gz,"Klebsiella michiganensis strain 4928STDY7387747, whole genome shotgun sequence",1,,1,0,1
GCF_902164935.1_25964_2_270_genomic.gbff.gz,"Klebsiella michiganensis strain 4928STDY7387756, whole genome shotgun sequence",0,All rRNA sequences shorter than 1400 bases,0,0
GCF_902164965.1_25964_2_267_genomic.gbff.gz,"Klebsiella michiganensis strain 4928STDY7387753, whole genome shotgun sequence",1,,1,0,1
GCF_902164975.1_25964_2_262_genomic.gbff.gz,"Klebsiella grimontii strain 4928STDY7387748, whole genome shotgun sequence",1,,1,0,1
GCF_902164985.1_25964_2_269_genomic.gbff.gz,"Klebsiella grimontii strain 4928STDY7387755, whole genome shotgun sequence",1,,1,0,1
GCF_902165095.1_25964_2_292_genomic.gbff.gz,"Klebsiella michiganensis strain 4928STDY7387779, whole genome shotgun sequence",1,,1,0,1
GCF_902165435.1_25964_2_341_genomic.gbff.gz,"Klebsiella grimontii strain 4928STDY7387828, whole genome shotgun sequence",1,,1,0,1
GCF_902165535.1_25964_2_347_genomic.gbff.gz,"Klebsiella grimontii strain 4928STDY7387834, whole genome shotgun sequence",0,All rRNA sequences shorter than 1400 bases,0,0
GCF_902165565.1_25964_2_342_genomic.gbff.gz,"Klebsiella grimontii strain 4928STDY7387829, whole genome shotgun sequence",1,,1,0,1
GCF_902165685.1_25964_2_363_genomic.gbff.gz,"Klebsiella grimontii strain 4928STDY7387850, whole genome shotgun sequence",1,,1,0,1
GCF_902165695.1_25964_2_355_genomic.gbff.gz,"Klebsiella grimontii strain 4928STDY7387842, whole genome shotgun sequence",0,All rRNA sequences shorter than 1400 bases,0,0
GCF_902166115.1_26009_2_29_genomic.gbff.gz,"Klebsiella michiganensis strain 4928STDY7387924, whole genome shotgun sequence",1,,1,0,1
GCF_902166145.1_26009_2_47_genomic.gbff.gz,"Klebsiella grimontii strain 4928STDY7387956, whole genome shotgun sequence",1,,1,0,1
GCF_902166185.1_26009_2_38_genomic.gbff.gz,"Klebsiella grimontii strain 4928STDY7387942, whole genome shotgun sequence",1,,1,0,1
GCF_902166275.1_26045_1_284_genomic.gbff.gz,"Klebsiella grimontii strain 4928STDY7071105, whole genome shotgun sequence",0,All rRNA sequences shorter than 1400 bases,0,0
GCF_902166285.1_26045_1_281_genomic.gbff.gz,"Klebsiella oxytoca strain 4928STDY7071102, whole genome shotgun sequence",1,,1,0,1
GCF_902166295.1_26045_1_282_genomic.gbff.gz,"Klebsiella michiganensis strain 4928STDY7071103, whole genome shotgun sequence",1,,1,0,1
GCF_902166305.1_26045_1_283_genomic.gbff.gz,"Klebsiella michiganensis strain 4928STDY7071104, whole genome shotgun sequence",1,,1,0,1
GCF_902166415.1_25964_2_54_genomic.gbff.gz,Klebsiella michiganensis strain 4928STDY7071186 chromosome 1,1,,1,0,1
GCF_902166425.1_25964_2_42_genomic.gbff.gz,Klebsiella michiganensis strain 4928STDY7071171 chromosome 1,1,,1,0,1
GCF_902166465.1_25964_2_27_genomic.gbff.gz,Klebsiella oxytoca strain 4928STDY7071151 chromosome 1,0,No matching 16S rRNA product criteria,0,0
GCF_902166545.1_25964_2_55_genomic.gbff.gz,Klebsiella grimontii strain 4928STDY7071187 chromosome 1,1,,1,0,1
GCF_902166555.1_25964_2_221_genomic.gbff.gz,Klebsiella michiganensis strain 4928STDY7387706 chromosome 1,0,No matching 16S rRNA product criteria,0,0
GCF_902166585.1_25964_2_273_genomic.gbff.gz,Klebsiella michiganensis strain 4928STDY7387759 chromosome 1,1,,1,0,1
GCF_902166625.1_25964_2_252_genomic.gbff.gz,Klebsiella michiganensis strain 4928STDY7387738 chromosome 1,1,,1,0,1
GCF_902166675.1_25964_2_276_genomic.gbff.gz,Klebsiella grimontii strain 4928STDY7387762 chromosome 1,1,,1,0,1
GCF_902166735.1_25964_2_277_genomic.gbff.gz,Klebsiella grimontii strain 4928STDY7387763 chromosome 1,1,,1,0,1
GCF_902166795.1_25964_2_253_genomic.gbff.gz,Klebsiella michiganensis strain 4928STDY7387739 chromosome 1,1,,1,0,1
GCF_902363365.1_MGYG-HGUT-00107_genomic.gbff.gz,"Klebsiella oxytoca isolate MGYG-HGUT-00107, whole genome shotgun sequence",1,,1,0,1
GCF_902386125.1_UHGG_MGYG-HGUT-02351_genomic.gbff.gz,"Klebsiella michiganensis isolate MGYG-HGUT-02351, whole genome shotgun sequence",8,,6,2,3
GCF_902705645.1_21863_KR315_genomic.gbff.gz,"Klebsiella oxytoca isolate KR315, whole genome shotgun sequence",0,All rRNA sequences shorter than 1400 bases,0,0
GCF_902705735.1_21865_KR359_genomic.gbff.gz,"Klebsiella oxytoca isolate KR359, whole genome shotgun sequence",0,All rRNA sequences shorter than 1400 bases,0,0
GCF_902705745.1_21871_KR401_genomic.gbff.gz,"Klebsiella oxytoca isolate KR401, whole genome shotgun sequence",0,All rRNA sequences shorter than 1400 bases,0,0
GCF_902754085.1_SFB9_genomic.gbff.gz,"Klebsiella michiganensis isolate SFB9, whole genome shotgun sequence",1,,1,0,1
GCF_902807095.1_PBIO727_genomic.gbff.gz,"Klebsiella michiganensis strain PBIO727, whole genome shotgun sequence",0,All rRNA sequences shorter than 1400 bases,0,0
GCF_904863345.1_MSB1_10D_genomic.gbff.gz,"Klebsiella oxytoca strain MSB1_10D isolate MSB1_10D chromosome 1, complete sequence",8,,8,0,1
GCF_905232115.1_AI2699v1_genomic.gbff.gz,"Klebsiella oxytoca isolate 325, whole genome shotgun sequence",8,,8,0,1
GCF_905232115.2_AI2699v1_cp_genomic.gbff.gz,"Klebsiella oxytoca isolate 325 chromosome main, complete sequence",8,,8,0,1
GCF_905322525.1_AI2623v1_genomic.gbff.gz,"Klebsiella oxytoca isolate 145, whole genome shotgun sequence",8,,8,0,1
GCF_905322525.2_AI2623v1_cpp_genomic.gbff.gz,"Klebsiella oxytoca isolate 145 chromosome main, complete sequence",8,,8,0,1
GCF_905329555.1_AI2744v1_genomic.gbff.gz,"Klebsiella oxytoca isolate 2, whole genome shotgun sequence",8,,8,0,1
GCF_905329555.2_AI2744v1_cpp_genomic.gbff.gz,"Klebsiella oxytoca isolate 2 chromosome main, complete sequence",8,,8,0,1
GCF_905330835.1_AI2945v1_genomic.gbff.gz,"Klebsiella oxytoca isolate 101, whole genome shotgun sequence",8,,8,0,1
GCF_905330835.2_AI2945v1_cpp_genomic.gbff.gz,"Klebsiella oxytoca isolate 101 chromosome main, complete sequence",8,,8,0,1
GCF_905330865.1_AI2946v1_genomic.gbff.gz,"Klebsiella oxytoca isolate 101, whole genome shotgun sequence",8,,8,0,1
GCF_905330865.2_AI2946v1_cpp_genomic.gbff.gz,"Klebsiella oxytoca isolate 101 chromosome main, complete sequence",8,,8,0,1
GCF_905331245.1_AI2991v1_genomic.gbff.gz,"Klebsiella oxytoca isolate 36, whole genome shotgun sequence",8,,4,4,1
GCF_905331245.2_AI2991v1_cpp_genomic.gbff.gz,"Klebsiella oxytoca isolate 36 plasmid P1, complete sequence",8,,4,4,1
GCF_905331355.1_AI3012v1_genomic.gbff.gz,"Klebsiella oxytoca isolate 2, whole genome shotgun sequence",8,,8,0,1
GCF_905331355.2_AI3012v1_cpp_genomic.gbff.gz,"Klebsiella oxytoca isolate 2 plasmid P1, complete sequence",8,,8,0,1
GCF_905333885.1_AI2918v1_genomic.gbff.gz,"Klebsiella oxytoca isolate 36, whole genome shotgun sequence",8,,4,4,1
GCF_905333885.2_AI2918v1_cp_genomic.gbff.gz,"Klebsiella oxytoca isolate 36 chromosome main, complete sequence",8,,4,4,1
GCF_905338025.1_AN2363v1_genomic.gbff.gz,"Klebsiella oxytoca isolate 328, whole genome shotgun sequence",8,,8,0,1
GCF_905338025.2_AN2363v1_cp_genomic.gbff.gz,"Klebsiella oxytoca isolate 328 chromosome main, complete sequence",8,,8,0,1
GCF_922826575.1_ARGID_31680_genomic.gbff.gz,"Klebsiella michiganensis strain ARGID_31680, whole genome shotgun sequence",8,,6,2,1
GCF_922831305.1_ARGID_32776_genomic.gbff.gz,"Klebsiella michiganensis strain ARGID_32776, whole genome shotgun sequence",8,,8,0,2
GCF_922832385.1_ARGID_29498_genomic.gbff.gz,"Klebsiella oxytoca strain ARGID_29498, whole genome shotgun sequence",8,,7,1,1
GCF_922832405.1_ARGID_32545_genomic.gbff.gz,"Klebsiella oxytoca strain ARGID_32545, whole genome shotgun sequence",8,,7,1,1
GCF_922832915.1_ARGID_31165_genomic.gbff.gz,"Klebsiella michiganensis strain ARGID_31165, whole genome shotgun sequence",8,,8,0,1
GCF_929608445.1_cpe088_genomic.gbff.gz,"Klebsiella oxytoca strain cpe088, whole genome shotgun sequence",1,,1,0,1
GCF_963887275.1_ena-yuan-GCF_010592905.1_genomic.gbff.gz,"Klebsiella michiganensis isolate ena-yuan-GCF_010592905.1 NZ_VLMM01000001.1, whole genome shotgun sequence",0,All rRNA sequences shorter than 1400 bases,0,0
GCF_963887975.1_ena-yuan-GCF_010590585.1_genomic.gbff.gz,"Klebsiella oxytoca isolate ena-yuan-GCF_010590585.1 NZ_VKTJ01000001.1, whole genome shotgun sequence",0,All rRNA sequences shorter than 1400 bases,0,0
GCF_964188435.1_kreshist0060_genomic.gbff.gz,"Klebsiella michiganensis isolate kreshist0060 1_kreshist0060, whole genome shotgun sequence",8,,8,0,1
GCF_964188445.1_kreshist0062_genomic.gbff.gz,"Klebsiella oxytoca isolate kreshist0062 1_kreshist0062, whole genome shotgun sequence",8,,7,1,1
GCF_964188455.1_kreshist0081_genomic.gbff.gz,"Klebsiella michiganensis isolate kreshist0081 1_kreshist0081, whole genome shotgun sequence",8,,8,0,1
GCF_964188465.1_kreshist0061_genomic.gbff.gz,"Klebsiella oxytoca isolate kreshist0061 1_kreshist0061, whole genome shotgun sequence",8,,6,2,2
GCF_964188475.1_kreshist0068_genomic.gbff.gz,"Klebsiella oxytoca isolate kreshist0068 1_kreshist0068, whole genome shotgun sequence",8,,8,0,1
GCF_964188485.1_kreshist0073_genomic.gbff.gz,"Klebsiella michiganensis isolate kreshist0073 1_kreshist0073, whole genome shotgun sequence",8,,8,0,1
GCF_964188495.1_kreshist0054_genomic.gbff.gz,"Klebsiella michiganensis isolate kreshist0054 1_kreshist0054, whole genome shotgun sequence",8,,8,0,1
GCF_964188505.1_kreshist0053_NY_genomic.gbff.gz,"Klebsiella michiganensis isolate kreshist0053 1_kreshist0053_NY, whole genome shotgun sequence",8,,8,0,1
GCF_964207135.1_FFZB_125.1_genomic.gbff.gz,"Klebsiella oxytoca strain FFZB-125 isolate FFZB_125 FFZB_125.1:1, whole genome shotgun sequence",0,All rRNA sequences shorter than 1400 bases,0,0
GCF_964207175.1_FFMG_1326-6-21.2_genomic.gbff.gz,"Klebsiella michiganensis strain FFMG-1326-6-21 isolate FFMG_1326-6-21 FFMG_1326-6-21.2:1, whole genome shotgun sequence",0,All rRNA sequences shorter than 1400 bases,0,0
GCF_964207205.1_FFDD_1141.1_genomic.gbff.gz,"Klebsiella oxytoca strain FFDD-1141 isolate FFDD_1141 FFDD_1141.1:1, whole genome shotgun sequence",0,All rRNA sequences shorter than 1400 bases,0,0
GCF_964207235.1_FFMG_1053-12-21.2_genomic.gbff.gz,"Klebsiella oxytoca strain FFMG-1053-12-21 isolate FFMG_1053-12-21 FFMG_1053-12-21.2:1, whole genome shotgun sequence",0,All rRNA sequences shorter than 1400 bases,0,0
GCF_964207295.1_FFSG_66-A-Q20.1_genomic.gbff.gz,"Klebsiella michiganensis strain FFSG-66-A-Q20 isolate FFSG_66-A-Q20 FFSG_66-A-Q20.1:1, whole genome shotgun sequence",0,All rRNA sequences shorter than 1400 bases,0,0
GCF_964207445.1_FFDD_3748.1_genomic.gbff.gz,"Klebsiella oxytoca strain FFDD-3748 isolate FFDD_3748 FFDD_3748.1:1, whole genome shotgun sequence",0,All rRNA sequences shorter than 1400 bases,0,0
GCF_964207475.1_FFMG_2228-3-21.2_genomic.gbff.gz,"Klebsiella michiganensis strain FFMG-2228-3-21 isolate FFMG_2228-3-21 FFMG_2228-3-21.2:1, whole genome shotgun sequence",0,All rRNA sequences shorter than 1400 bases,0,0
GCF_964207735.1_FFDD_533336-L504.1_genomic.gbff.gz,"Klebsiella michiganensis strain FFDD-533336-L504 isolate FFDD_533336-L504 FFDD_533336-L504.1:1, whole genome shotgun sequence",0,All rRNA sequences shorter than 1400 bases,0,0
GCF_964241835.1_CC00890_genomic.gbff.gz,"Klebsiella oxytoca MGH 42 isolate CC00890 CC00890_1_NODE_1_length_384443_cov_128.531595, whole genome shotgun sequence",1,,1,0,1
GCF_964243925.1_CC00103_genomic.gbff.gz,"Klebsiella michiganensis isolate CC00103 CC00103_1_NODE_1_length_587713_cov_36.499847, whole genome shotgun sequence",0,All rRNA sequences shorter than 1400 bases,0,0
GCF_964248175.1_CC00090_genomic.gbff.gz,"Klebsiella michiganensis isolate CC00090 CC00090_1_NODE_1_length_587713_cov_55.015613, whole genome shotgun sequence",0,All rRNA sequences shorter than 1400 bases,0,0
